id,unicode,X,Y,population,travellers,visitors
1,1001,9921,4453,1679,636,1043
2,1002,9919,4451,12241,6664,5577
3,1003,9919,4450,5894,2970,2924
4,1004,9920,4453,3938,1830,2108
5,1005,9923,4451,5598,2790,2808
6,1006,9931,4451,5159,2539,2620
7,1007,9929,4450,1657,929,728
8,1008,9925,4452,7720,3927,3793
9,1009,9925,4451,5291,2502,2789
10,1010,9925,4447,5206,2688,2518
11,1011,9916,4449,11205,5948,5257
12,1012,9916,4448,7925,4017,3908
13,1013,9918,4442,6594,3616,2978
14,1014,9917,4442,13738,8408,5330
15,1015,9916,4441,3022,1707,1315
16,1016,9915,4447,6015,2678,3337
17,1017,9916,4447,2439,1087,1352
18,1018,9922,4453,2568,1229,1339
19,1019,9922,4447,6406,3263,3143
20,1020,9925,4449,9458,4912,4546
21,1021,9923,4448,7295,3734,3561
22,1022,9921,4449,5958,3135,2823
23,1023,9918,4446,4954,2615,2339
24,1024,9916,4445,5408,2760,2648
25,1025,9925,4453,4440,2126,2314
26,1026,9926,4451,9584,5435,4149
27,1027,9919,4444,8717,4734,3983
28,1028,9920,4443,7871,4323,3548
29,1029,9920,4445,12188,5974,6214
30,1030,9917,4447,7735,4162,3573
31,1031,9917,4449,5477,2843,2634
32,1032,9921,4447,10024,5036,4988
33,1033,9921,4448,3008,1392,1616
34,1034,9927,4447,5514,2776,2738
35,1035,9922,4450,7548,3905,3643
36,1036,9919,4449,6296,3289,3007
37,1037,9926,4449,5554,2826,2728
38,1038,9920,4444,9588,4823,4765
39,1039,9922,4443,4123,2294,1829
40,1040,9927,4448,5119,2507,2612
41,1041,9928,4445,8071,4162,3909
42,1042,9931,4445,3170,1584,1586
43,1043,9929,4445,11527,5678,5849
44,1044,9928,4446,6132,3088,3044
45,1045,9929,4447,6089,3340,2749
46,1046,9930,4444,6864,3746,3118
47,1047,9931,4446,2647,1288,1359
48,1048,9941,4457,393,196,197
49,1049,9943,4458,11135,1834,9301
50,1050,9937,4459,165,84,81
51,1051,9929,4446,6141,3092,3049
52,1052,9923,4449,6914,3862,3052
53,1053,9918,4445,9480,4969,4511
54,1054,9932,4449,2825,1354,1471
55,1055,9932,4450,2867,1419,1448
56,1056,9928,4448,8965,4392,4573
57,1057,9921,4438,2988,1601,1387
58,1058,9921,4440,8465,4396,4069
59,1059,9918,4441,17974,4433,13541
60,1060,9920,4442,8340,4463,3877
61,1061,9922,4442,15919,7937,7982
62,1062,9925,4446,4966,2524,2442
63,1063,9925,4445,4169,2127,2042
64,1064,9932,4441,3312,1665,1647
65,1065,9931,4442,13068,6850,6218
66,1066,9930,4440,6231,3274,2957
67,1067,9930,4448,3346,1601,1745
68,1068,9923,4452,5571,2910,2661
69,1069,9929,4452,2867,1226,1641
70,1070,9930,4453,4126,2163,1963
71,1071,9933,4436,160,35,125
72,1072,9930,4439,8400,4312,4088
73,1073,9930,4438,4852,2435,2417
74,1074,9927,4446,9053,4662,4391
75,1075,9924,4439,7069,3603,3466
76,1076,9919,4438,3095,1299,1796
77,1077,9923,4437,8268,1689,6579
78,1078,9923,4438,1957,939,1018
79,1079,9923,4436,4103,2200,1903
80,1080,9922,4437,3846,1710,2136
81,1081,9918,4439,6649,3263,3386
82,1082,9917,4440,7703,4541,3162
83,1083,9917,4439,9492,5068,4424
84,1084,9914,4436,1977,1202,775
85,1085,9918,4444,6832,3316,3516
86,1086,9917,4444,9155,5167,3988
87,1087,9914,4446,4382,2529,1853
88,1088,9917,4445,7068,3685,3383
89,1089,9919,4448,4082,1814,2268
90,1090,9919,4452,5117,2581,2536
91,1091,9911,4446,592,273,319
92,1092,9916,4450,7044,3760,3284
93,1093,9912,4449,1229,415,814
94,1094,9914,4449,1353,714,639
95,1095,9914,4442,15004,8464,6540
96,1096,9920,4450,7687,4247,3440
97,1097,9921,4450,9008,4596,4412
98,1098,9923,4442,1442,602,840
99,1099,9924,4441,5613,2535,3078
100,1100,9920,4440,7099,3780,3319
101,1101,9918,4440,9963,4646,5317
102,1102,9919,4445,9485,4809,4676
103,1103,9909,4451,715,299,416
104,1104,9910,4452,200,95,105
105,1105,9914,4453,458,198,260
106,1106,9915,4452,1679,1036,643
107,1107,9918,4449,10458,5730,4728
108,1108,9918,4447,7085,3624,3461
109,1109,9909,4447,477,238,239
110,1110,9926,4437,5627,2960,2667
111,1111,9926,4436,6697,3914,2783
112,1112,9925,4437,2480,1221,1259
113,1113,9923,4439,5256,2833,2423
114,1114,9945,4440,373,140,233
115,1115,9938,4443,1102,520,582
116,1116,9940,4442,442,228,214
117,1117,9939,4447,13,3,10
118,1118,9937,4447,64,18,46
119,1119,9933,4444,3148,1434,1714
120,1120,9920,4439,6091,3264,2827
121,1121,9922,4438,3036,1370,1666
122,1122,9921,4437,5164,2707,2457
123,1123,9916,4440,4028,2051,1977
124,1124,9921,4439,5392,2817,2575
125,1125,9937,4442,382,182,200
126,1126,9926,4442,9023,4585,4438
127,1127,9921,4442,9767,5085,4682
128,1128,9915,4438,3148,1412,1736
129,1129,9915,4440,2236,1230,1006
130,1130,9919,4453,1220,628,592
131,1131,9918,4451,5508,3156,2352
132,1132,9919,4437,2140,1022,1118
133,1133,9918,4436,797,423,374
134,1134,9920,4451,7044,3587,3457
135,1135,9917,4448,5791,3061,2730
136,1136,9920,4438,4881,2481,2400
137,1137,9915,4437,5982,3280,2702
138,1138,9916,4435,1127,513,614
139,1139,9918,4438,3269,1411,1858
140,1140,9918,4437,1066,603,463
141,1141,9915,4435,3476,1856,1620
142,1142,9914,4435,1932,995,937
143,1143,9907,4435,74,25,49
144,1144,9923,4434,1818,930,888
145,1145,9919,4440,7111,3608,3503
146,1146,9922,4445,4091,2046,2045
147,1147,9924,4445,5461,2859,2602
148,1148,9925,4442,4196,1808,2388
149,1149,9914,4441,6543,3448,3095
150,1150,9922,4435,2968,1401,1567
151,1151,9926,4452,5621,2756,2865
152,1152,9924,4451,1330,558,772
153,1153,9924,4446,4059,2157,1902
154,1154,9922,4444,3503,1805,1698
155,1155,9929,4442,10445,5143,5302
156,1156,9929,4443,8851,4296,4555
157,1157,9921,4446,7961,4604,3357
158,1158,9922,4449,7279,4109,3170
159,1159,9924,4450,1943,1143,800
160,1160,9907,4442,2401,1224,1177
161,1161,9910,4442,4303,2386,1917
162,1162,9919,4442,5193,2598,2595
163,1163,9919,4441,4835,2540,2295
164,1164,9928,4436,4111,2213,1898
165,1165,9929,4436,2478,1010,1468
166,1166,9925,4440,3534,1796,1738
167,1167,9924,4440,3504,1989,1515
168,1168,9920,4435,2018,1037,981
169,1169,9931,4450,3583,1754,1829
170,1170,9931,4452,3739,1855,1884
171,1171,9930,4452,5607,2604,3003
172,1172,9923,4441,4377,2268,2109
173,1173,9920,4449,6121,3285,2836
174,1174,9926,4457,2149,1094,1055
175,1175,9940,4461,1358,414,944
176,1176,9930,4446,7067,3840,3227
177,1177,9930,4447,8083,4068,4015
178,1178,9928,4442,7154,3629,3525
179,1179,9935,4456,153,77,76
180,1180,9928,4440,4657,2436,2221
181,1181,9924,4437,4114,1948,2166
182,1182,9934,4453,406,166,240
183,1183,9930,4451,4855,2538,2317
184,1184,9930,4449,655,293,362
185,1185,9928,4441,2423,1086,1337
186,1186,9920,4423,188,87,101
187,1187,9925,4448,5766,2702,3064
188,1188,9927,4442,13538,6441,7097
189,1189,9926,4441,10887,5859,5028
190,1190,9927,4449,4941,2452,2489
191,1191,9922,4448,3769,1774,1995
192,1192,9916,4434,1595,716,879
193,1193,9915,4436,3190,1623,1567
194,1194,9913,4435,524,296,228
195,1195,9917,4434,860,398,462
196,1196,9916,4438,761,189,572
197,1197,9924,4449,4874,2547,2327
198,1198,9924,4447,4854,2411,2443
199,1199,9916,4444,9332,5116,4216
200,1200,9917,4443,1837,953,884
201,1201,9918,4450,6187,3169,3018
202,1202,9920,4455,1399,649,750
203,1203,9922,4446,8560,4749,3811
204,1204,9923,4445,3246,1529,1717
205,1205,9913,4440,4264,1976,2288
206,1206,9916,4436,2282,1115,1167
207,1207,9912,4443,3570,1882,1688
208,1208,9912,4441,2961,1569,1392
209,1209,9920,4433,1116,653,463
210,1210,9922,4434,5455,2483,2972
211,1211,9921,4434,750,381,369
212,1212,9921,4436,3334,1934,1400
213,1213,9922,4436,4357,2228,2129
214,1214,9915,4434,5636,3241,2395
215,1215,9915,4433,2041,1007,1034
216,1216,9922,4441,6313,3473,2840
217,1217,9918,4423,56,23,33
218,1218,9941,4461,9678,3303,6375
219,1219,9930,4442,10881,5872,5009
220,1220,9927,4436,3798,1915,1883
221,1221,9925,4436,4913,2372,2541
222,1222,9921,4445,9050,5008,4042
223,1223,9918,4448,7963,3889,4074
224,1224,9914,4443,6811,3626,3185
225,1225,9916,4451,4404,2396,2008
226,1226,9919,4459,772,402,370
227,1227,9921,4443,11150,5323,5827
228,1228,9921,4444,5200,2819,2381
229,1229,9916,4458,4056,2495,1561
230,1230,9910,4441,4197,2442,1755
231,1231,9912,4442,7130,4251,2879
232,1232,9911,4441,4497,2452,2045
233,1233,9906,4432,18,5,13
234,1234,9917,4437,2136,933,1203
235,1235,9931,4444,4235,2068,2167
236,1236,9929,4444,6054,2845,3209
237,1237,9929,4441,3125,1588,1537
238,1238,9912,4440,4123,2041,2082
239,1239,9925,4466,92,43,49
240,1240,9925,4459,374,134,240
241,1241,9926,4459,1236,678,558
242,1242,9908,4451,1269,729,540
243,1243,9917,4450,15746,7463,8283
244,1244,9927,4450,3405,1625,1780
245,1245,9916,4443,3301,1592,1709
246,1246,9915,4451,1437,549,888
247,1247,9916,4452,1886,894,992
248,1248,9917,4432,340,131,209
249,1249,9917,4433,1359,575,784
250,1250,9916,4439,4174,1939,2235
251,1251,9906,4443,881,370,511
252,1252,9919,4462,394,125,269
253,1253,9928,4449,4501,2499,2002
254,1254,9928,4447,4733,2411,2322
255,1255,9920,4437,1167,555,612
256,1256,9918,4435,3506,1870,1636
257,1257,9922,4439,5992,3312,2680
258,1258,9921,4427,191,103,88
259,1259,9923,4440,3197,1756,1441
260,1260,9924,4429,1170,525,645
261,1261,9917,4438,3612,1919,1693
262,1262,9925,4438,1525,775,750
263,1263,9938,4435,240,75,165
264,1264,9931,4438,2235,979,1256
265,1265,9923,4433,277,190,87
266,1266,9926,4446,6212,3104,3108
267,1267,9913,4441,3853,2006,1847
268,1268,9916,4442,10412,5847,4565
269,1269,9913,4442,6925,3586,3339
270,1270,9913,4444,5371,2789,2582
271,1271,9911,4440,1025,380,645
272,1272,9902,4446,217,157,60
273,1273,9902,4444,25,12,13
274,1274,9915,4444,7675,3969,3706
275,1275,9915,4442,8857,4845,4012
276,1276,9907,4445,1538,829,709
277,1277,9906,4445,933,406,527
278,1278,9911,4444,1251,572,679
279,1279,9913,4443,3457,1871,1586
280,1280,9923,4450,6654,3560,3094
281,1281,9926,4448,4676,2344,2332
282,1282,9911,4443,680,152,528
283,1283,9920,4454,2752,1215,1537
284,1284,9908,4441,1263,502,761
285,1285,9908,4443,1567,682,885
286,1286,9906,4444,3501,2504,997
287,1287,9899,4444,49,9,40
288,1288,9930,4445,5692,3026,2666
289,1289,9924,4444,1979,971,1008
290,1290,9926,4447,4434,2289,2145
291,1291,9919,4447,5896,3028,2868
292,1292,9920,4452,5705,2737,2968
293,1293,9930,4443,5900,3163,2737
294,1294,9920,4446,7159,4043,3116
295,1295,9916,4446,8024,4312,3712
296,1296,9937,4436,9,0,9
297,1297,9914,4445,3320,1719,1601
298,1298,9915,4446,4201,2146,2055
299,1299,9920,4447,5321,2608,2713
300,1300,9911,4447,347,104,243
301,1301,9920,4448,3627,1675,1952
302,1302,9925,4441,2871,1517,1354
303,1303,9921,4441,8296,4476,3820
304,1304,9924,4435,2287,1089,1198
305,1305,9917,4456,4492,2349,2143
306,1306,9925,4444,3314,1741,1573
307,1307,9927,4444,5207,2647,2560
308,1308,9925,4455,544,233,311
309,1309,9925,4456,358,130,228
310,1310,9926,4453,1874,1013,861
311,1311,9930,4454,1821,1024,797
312,1312,9922,4456,901,380,521
313,1313,9917,4451,6165,3404,2761
314,1314,9921,4451,4422,2494,1928
315,1315,9924,4442,1108,468,640
316,1316,9923,4453,551,196,355
317,1317,9922,4452,3337,1693,1644
318,1318,9931,4447,2317,1068,1249
319,1319,9925,4443,6310,3256,3054
320,1320,9922,4440,6159,3434,2725
321,1321,9929,4440,3822,1885,1937
322,1322,9917,4435,1582,647,935
323,1323,9919,4432,1119,486,633
324,1324,9913,4461,937,446,491
325,1325,9913,4460,224,113,111
326,1326,9914,4463,129,64,65
327,1327,9914,4460,124,37,87
328,1328,9915,4458,669,281,388
329,1329,9916,4457,2631,1413,1218
330,1330,9913,4462,150,46,104
331,1331,9914,4452,1914,966,948
332,1332,9913,4458,484,199,285
333,1333,9911,4460,250,149,101
334,1334,9911,4463,40,16,24
335,1335,9917,4457,1441,770,671
336,1336,9917,4458,1474,742,732
337,1337,9909,4460,75,37,38
338,1338,9914,4447,6949,3723,3226
339,1339,9926,4443,4863,2511,2352
340,1340,9918,4458,1299,669,630
341,1341,9919,4457,1235,572,663
342,1342,9919,4456,2226,1143,1083
343,1343,9915,4456,806,363,443
344,1344,9916,4455,1085,488,597
345,1345,9919,4455,248,100,148
346,1346,9924,4448,4323,1996,2327
347,1347,9925,4457,893,389,504
348,1348,9920,4459,767,356,411
349,1349,9917,4455,2694,1468,1226
350,1350,9918,4454,623,248,375
351,1351,9912,4444,3352,1593,1759
352,1352,9931,4441,3110,1538,1572
353,1353,9928,4444,11984,6305,5679
354,1354,9926,4461,676,388,288
355,1355,9938,4475,4,1,3
356,1356,9926,4463,77,30,47
357,1357,9933,4442,2595,1122,1473
358,1358,9938,4460,421,256,165
359,1359,9932,4448,2883,1380,1503
360,1360,9927,4452,1995,850,1145
361,1361,9931,4453,2437,1337,1100
362,1362,9932,4453,950,533,417
363,1363,9930,4450,3424,1829,1595
364,1364,9927,4445,8332,4401,3931
365,1365,9926,4450,6280,3165,3115
366,1366,9933,4447,599,270,329
367,1367,9921,4452,3775,1853,1922
368,1368,9917,4453,966,554,412
369,1369,9919,4446,2105,985,1120
370,1370,9908,4452,602,117,485
371,1371,9909,4435,52,28,24
372,1372,9914,4444,4007,2043,1964
373,1373,9905,4444,1564,830,734
374,1374,9900,4448,183,86,97
375,1375,9931,4440,3650,1901,1749
376,1376,9931,4439,2329,1140,1189
377,1377,9921,4459,605,292,313
378,1378,9913,4453,519,251,268
379,1379,9910,4440,2393,1174,1219
380,1380,9913,4436,1815,1003,812
381,1381,9917,4436,4068,1977,2091
382,1382,9913,4434,264,68,196
383,1383,9913,4437,2918,1629,1289
384,1384,9914,4438,5548,3530,2018
385,1385,9915,4439,1034,464,570
386,1386,9917,4441,6649,3252,3397
387,1387,9913,4439,3400,1767,1633
388,1388,9915,4453,834,334,500
389,1389,9918,4424,146,62,84
390,1390,9927,4438,1523,649,874
391,1391,9929,4437,1606,856,750
392,1392,9912,4438,1036,518,518
393,1393,9924,4452,2256,1017,1239
394,1394,9922,4454,1571,757,814
395,1395,9929,4448,7498,3877,3621
396,1396,9938,4462,106,56,50
397,1397,9925,4450,3148,1607,1541
398,1398,9918,4460,1642,793,849
399,1399,9916,4456,1032,400,632
400,1400,9915,4450,841,291,550
401,1401,9928,4452,608,457,151
402,1402,9933,4450,1044,373,671
403,1403,9923,4447,5426,2782,2644
404,1404,9919,4443,4810,2479,2331
405,1405,9933,4448,2064,906,1158
406,1406,9929,4439,4454,2110,2344
407,1407,9927,4441,3248,1658,1590
408,1408,9920,4441,4755,2533,2222
409,1409,9920,4461,480,215,265
410,1410,9919,4460,1376,713,663
411,1411,9917,4461,678,320,358
412,1412,9920,4456,2132,1025,1107
413,1413,9927,4459,252,82,170
414,1414,9918,4456,2885,1674,1211
415,1415,9918,4457,1329,634,695
416,1416,9926,4455,1634,879,755
417,1417,9926,4456,2077,1081,996
418,1418,9921,4470,1,0,1
419,1419,9903,4431,44,21,23
420,1420,9915,4457,646,292,354
421,1421,9914,4455,2199,1207,992
422,1422,9915,4443,3003,1309,1694
423,1423,9927,4440,4741,2477,2264
424,1424,9915,4441,3676,1955,1721
425,1425,9946,4466,43,13,30
426,1426,9937,4460,377,138,239
427,1427,9935,4462,28,7,21
428,1428,9921,4456,1805,902,903
429,1429,9922,4461,431,155,276
430,1430,9923,4446,2328,1172,1156
431,1431,9927,4451,4101,2045,2056
432,1432,9915,4449,3970,2410,1560
433,1433,9914,4440,3383,1835,1548
434,1434,9931,4443,4239,2173,2066
435,1435,9926,4445,2829,1559,1270
436,1436,9933,4451,796,345,451
437,1437,9931,4448,781,436,345
438,1438,9932,4451,2916,1561,1355
439,1439,9923,4444,3338,1661,1677
440,1440,9927,4431,61,5,56
441,1441,9926,4430,1215,698,517
442,1442,9922,4451,5147,2685,2462
443,1443,9937,4443,682,347,335
444,1444,9938,4449,155,59,96
445,1445,9939,4451,9,3,6
446,1446,9928,4451,2418,1205,1213
447,1447,9933,4439,516,155,361
448,1448,9932,4444,1741,903,838
449,1449,9904,4431,292,153,139
450,1450,9937,4437,100,27,73
451,1451,9913,4454,1696,941,755
452,1452,9912,4460,209,95,114
453,1453,9912,4458,684,339,345
454,1454,9920,4457,1184,567,617
455,1455,9926,4444,3932,2041,1891
456,1456,9927,4453,486,194,292
457,1457,9945,4442,263,141,122
458,1458,9935,4444,1308,642,666
459,1459,9917,4446,5966,3113,2853
460,1460,9930,4441,5591,3045,2546
461,1461,9932,4452,811,404,407
462,1462,9918,4455,317,64,253
463,1463,9890,4418,3,2,1
464,1464,9900,4421,6,2,4
465,1465,9928,4434,800,481,319
466,1466,9929,4438,4781,2188,2593
467,1467,9934,4429,219,119,100
468,1468,9934,4430,530,287,243
469,1469,9926,4438,2489,1336,1153
470,1470,9920,4436,996,496,500
471,1471,9927,4439,2393,1256,1137
472,1472,9924,4436,5103,2536,2567
473,1473,9925,4431,975,544,431
474,1474,9934,4441,534,157,377
475,1475,9929,4435,371,128,243
476,1476,9921,4429,402,170,232
477,1477,9940,4444,542,239,303
478,1478,9941,4446,41,14,27
479,1479,9939,4448,54,24,30
480,1480,9938,4448,123,38,85
481,1481,9935,4442,1009,508,501
482,1482,9939,4442,560,242,318
483,1483,9926,4435,2542,1128,1414
484,1484,9919,4428,226,92,134
485,1485,9919,4425,458,254,204
486,1486,9930,4437,2559,1353,1206
487,1487,9936,4437,83,13,70
488,1488,9934,4444,2786,1387,1399
489,1489,9948,4442,37,16,21
490,1490,9934,4442,2024,861,1163
491,1491,9935,4443,2137,1041,1096
492,1492,9932,4443,3942,1958,1984
493,1493,9934,4443,2372,1068,1304
494,1494,9932,4440,1757,940,817
495,1495,9928,4438,3558,1714,1844
496,1496,9919,4421,87,28,59
497,1497,9925,4432,1005,590,415
498,1498,9927,4428,138,77,61
499,1499,9925,4426,46,22,24
500,1500,9927,4422,15,4,11
501,1501,9919,4439,3797,1541,2256
502,1502,9939,4456,70,38,32
503,1503,9937,4463,122,73,49
504,1504,9936,4457,87,46,41
505,1505,9928,4459,133,50,83
506,1506,9921,4454,656,259,397
507,1507,9918,4461,1308,679,629
508,1508,9918,4464,48,8,40
509,1509,9912,4466,113,52,61
510,1510,9949,4440,71,23,48
511,1511,9927,4443,5534,3045,2489
512,1512,9929,4454,364,137,227
513,1513,9912,4450,318,137,181
514,1514,9901,4422,15,7,8
515,1515,9898,4422,2,0,2
516,1516,9933,4443,3199,1670,1529
517,1517,9924,4443,363,177,186
518,1518,9914,4439,3090,1711,1379
519,1519,9912,4447,215,18,197
520,1520,9914,4437,2255,1264,991
521,1521,9919,4433,655,258,397
522,1522,9920,4463,23,4,19
523,1523,9959,4446,6,1,5
524,1524,9945,4444,188,68,120
525,1525,9937,4448,533,241,292
526,1526,9941,4452,8,0,8
527,1527,9936,4445,98,12,86
528,1528,9924,4438,3007,1403,1604
529,1529,9919,4458,433,163,270
530,1530,9919,4435,2678,1535,1143
531,1531,9910,4435,939,595,344
532,1532,9912,4445,535,146,389
533,1533,9913,4449,619,331,288
534,1534,9931,4449,2550,1236,1314
535,1535,9933,4449,921,401,520
536,1536,9927,4456,660,262,398
537,1537,9928,4456,574,301,273
538,1538,9945,4441,190,68,122
539,1539,9934,4436,350,72,278
540,1540,9934,4437,877,318,559
541,1541,9935,4440,438,201,237
542,1542,9929,4453,316,120,196
543,1543,9935,4431,91,33,58
544,1544,9938,4446,164,61,103
545,1545,9937,4446,246,133,113
546,1546,9931,4435,172,35,137
547,1547,9914,4448,6007,3060,2947
548,1548,9925,4429,98,27,71
549,1549,9925,4435,1057,385,672
550,1550,9935,4430,164,75,89
551,1551,9916,4462,458,254,204
552,1552,9916,4461,559,249,310
553,1553,9934,4433,126,48,78
554,1554,9912,4437,1358,690,668
555,1555,9910,4449,165,61,104
556,1556,9906,4442,1545,697,848
557,1557,9919,4430,387,174,213
558,1558,9918,4432,148,52,96
559,1559,9920,4432,547,307,240
560,1560,9924,4434,1070,492,578
561,1561,9921,4435,3255,1721,1534
562,1562,9922,4433,465,222,243
563,1563,9909,4442,4693,2573,2120
564,1564,9908,4450,234,87,147
565,1565,9913,4445,443,55,388
566,1566,9913,4455,1236,527,709
567,1567,9908,4447,107,39,68
568,1568,9938,4442,1070,499,571
569,1569,9914,4456,856,411,445
570,1570,9933,4453,403,212,191
571,1571,9929,4449,2341,1056,1285
572,1572,9916,4431,76,9,67
573,1573,9908,4448,341,132,209
574,1574,9908,4442,2800,1580,1220
575,1575,9908,4446,867,377,490
576,1576,9912,4439,602,213,389
577,1577,9919,4422,396,180,216
578,1578,9927,4437,5991,3068,2923
579,1579,9917,4430,101,38,63
580,1580,9935,4455,303,172,131
581,1581,9934,4455,283,118,165
582,1582,9909,4441,3169,1807,1362
583,1583,9923,4426,159,71,88
584,1584,9925,4434,860,385,475
585,1585,9914,4432,314,103,211
586,1586,9933,4445,3226,1488,1738
587,1587,9925,4461,255,80,175
588,1588,9926,4458,514,232,282
589,1589,9928,4450,1164,632,532
590,1590,9925,4460,605,267,338
591,1591,9908,4432,247,147,100
592,1592,9917,4452,2676,1413,1263
593,1593,9948,4445,27,2,25
594,1594,9925,4439,166,71,95
595,1595,9931,4437,1047,535,512
596,1596,9926,4440,3741,1931,1810
597,1597,9933,4441,1907,811,1096
598,1598,9933,4437,1507,715,792
599,1599,9927,4435,2523,1096,1427
600,1600,9931,4454,423,184,239
601,1601,9944,4441,120,39,81
602,1602,9936,4460,247,148,99
603,1603,9908,4457,217,124,93
604,1604,9905,4460,16,5,11
605,1605,9928,4455,293,94,199
606,1606,9918,4453,608,134,474
607,1607,9932,4463,88,63,25
608,1608,9928,4462,78,20,58
609,1609,9928,4461,220,117,103
610,1610,9926,4460,608,259,349
611,1611,9927,4462,17,8,9
612,1612,9911,4477,58,19,39
613,1613,9917,4459,176,66,110
614,1614,9920,4460,341,90,251
615,1615,9928,4443,4181,1813,2368
616,1616,9944,4442,252,93,159
617,1617,9939,4459,348,202,146
618,1618,9933,4440,471,267,204
619,1619,9930,4434,487,237,250
620,1620,9912,4436,839,379,460
621,1621,9920,4434,758,366,392
622,1622,9928,4437,2691,1341,1350
623,1623,9905,4442,266,101,165
624,1624,9921,4431,201,75,126
625,1625,9924,4431,469,175,294
626,1626,9927,4427,113,32,81
627,1627,9928,4430,399,197,202
628,1628,9925,4427,20,5,15
629,1629,9922,4430,347,166,181
630,1630,9923,4431,41,7,34
631,1631,9918,4434,831,293,538
632,1632,9932,4445,1836,981,855
633,1633,9927,4457,868,431,437
634,1634,9928,4460,249,93,156
635,1635,9913,4456,871,439,432
636,1636,9912,4453,957,395,562
637,1637,9921,4432,202,72,130
638,1638,9923,4435,2862,1363,1499
639,1639,9929,4451,1304,620,684
640,1640,9916,4433,648,334,314
641,1641,9899,4442,42,8,34
642,1642,9907,4446,1533,676,857
643,1643,9907,4444,3457,1735,1722
644,1644,9907,4443,2655,1338,1317
645,1645,9904,4442,26,1,25
646,1646,9908,4444,1728,745,983
647,1647,9904,4445,430,230,200
648,1648,9897,4445,49,8,41
649,1649,9938,4438,93,43,50
650,1650,9921,4460,772,370,402
651,1651,9934,4448,87,16,71
652,1652,9911,4442,1250,668,582
653,1653,9909,4429,16,7,9
654,1654,9902,4423,91,30,61
655,1655,9912,4435,536,364,172
656,1656,9935,4461,229,131,98
657,1657,9939,4465,21,16,5
658,1658,9940,4459,358,212,146
659,1659,9935,4450,121,47,74
660,1660,9943,4457,179,72,107
661,1661,9927,4430,330,130,200
662,1662,9912,4446,1476,651,825
663,1663,9915,4448,5586,2632,2954
664,1664,9915,4464,293,140,153
665,1665,9928,4435,1495,723,772
666,1666,9929,4465,60,27,33
667,1667,9930,4466,8,4,4
668,1668,9936,4438,297,103,194
669,1669,9932,4442,2318,1215,1103
670,1670,9932,4439,1625,719,906
671,1671,9932,4435,452,230,222
672,1672,9931,4436,665,292,373
673,1673,9938,4454,102,50,52
674,1674,9936,4461,56,21,35
675,1675,9909,4448,61,4,57
676,1676,9918,4459,599,271,328
677,1677,9917,4460,501,299,202
678,1678,9937,4439,45,8,37
679,1679,9918,4426,109,53,56
680,1680,9915,4432,1373,665,708
681,1681,9907,4451,288,104,184
682,1682,9900,4414,2,1,1
683,1683,9896,4413,5,1,4
684,1684,9910,4426,17,16,1
685,1685,9919,4420,23,13,10
686,1686,9920,4425,258,143,115
687,1687,9912,4434,287,93,194
688,1688,9931,4430,715,401,314
689,1689,9917,4454,1332,662,670
690,1690,9914,4461,53,6,47
691,1691,9910,4461,135,33,102
692,1692,9915,4445,2227,954,1273
693,1693,9909,4437,25,2,23
694,1694,9923,4443,634,269,365
695,1695,9921,4457,93,29,64
696,1696,9910,4444,587,215,372
697,1697,9938,4431,22,2,20
698,1698,9933,4435,87,15,72
699,1699,9932,4437,690,380,310
700,1700,9946,4440,245,107,138
701,1701,9926,4434,1303,601,702
702,1702,9902,4421,19,9,10
703,1703,9920,4421,148,77,71
704,1704,9931,4462,153,86,67
705,1705,9931,4463,25,15,10
706,1706,9930,4457,121,36,85
707,1707,9934,4445,2059,977,1082
708,1708,9929,4455,252,107,145
709,1709,9931,4434,416,232,184
710,1710,9927,4460,483,218,265
711,1711,9932,4430,698,381,317
712,1712,9904,4444,1201,669,532
713,1713,9915,4429,455,166,289
714,1714,9900,4445,517,232,285
715,1715,9901,4447,157,82,75
716,1716,9899,4445,336,92,244
717,1717,9928,4439,2249,1194,1055
718,1718,9926,4439,2091,1172,919
719,1719,9910,4438,284,135,149
720,1720,9932,4438,993,614,379
721,1721,9924,4432,266,58,208
722,1722,9916,4454,105,14,91
723,1723,9932,4447,522,285,237
724,1724,9938,4447,168,93,75
725,1725,9947,4471,10,7,3
726,1726,9911,4456,212,43,169
727,1727,9914,4467,17,2,15
728,1728,9909,4465,18,2,16
729,1729,9915,4454,952,405,547
730,1730,9924,4453,577,235,342
731,1731,9908,4456,291,144,147
732,1732,9904,4461,28,9,19
733,1733,9936,4440,46,8,38
734,1734,9914,4433,505,196,309
735,1735,9918,4433,468,228,240
736,1736,9916,4437,2423,1253,1170
737,1737,9910,4436,215,38,177
738,1738,9927,4463,14,2,12
739,1739,9921,4461,330,116,214
740,1740,9939,4441,99,26,73
741,1741,9924,4464,70,24,46
742,1742,9926,4467,41,11,30
743,1743,9935,4439,190,74,116
744,1744,9919,4429,503,215,288
745,1745,9921,4420,3,0,3
746,1746,9918,4429,300,153,147
747,1747,9911,4445,334,62,272
748,1748,9915,4455,1346,663,683
749,1749,9918,4443,175,16,159
750,1750,9936,4443,845,469,376
751,1751,9948,4437,43,19,24
752,1752,9933,4438,1076,499,577
753,1753,9930,4436,605,217,388
754,1754,9941,4458,425,219,206
755,1755,9938,4459,418,224,194
756,1756,9924,4430,188,95,93
757,1757,9919,4426,135,68,67
758,1758,9920,4424,136,76,60
759,1759,9920,4430,426,218,208
760,1760,9914,4454,1168,561,607
761,1761,9918,4427,382,232,150
762,1762,9905,4432,85,39,46
763,1763,9941,4443,578,256,322
764,1764,9937,4426,227,118,109
765,1765,9934,4428,221,109,112
766,1766,9910,4439,426,178,248
767,1767,9946,4441,105,32,73
768,1768,9934,4440,319,170,149
769,1769,9939,4457,130,63,67
770,1770,9914,4451,411,171,240
771,1771,9897,4451,1,0,1
772,1772,9939,4444,179,89,90
773,1773,9913,4457,122,54,68
774,1774,9926,4429,352,177,175
775,1775,9936,4426,99,37,62
776,1776,9939,4443,364,197,167
777,1777,9940,4443,660,333,327
778,1778,9904,4437,44,19,25
779,1779,9907,4436,117,34,83
780,1780,9905,4440,22,6,16
781,1781,9909,4449,326,149,177
782,1782,9929,4425,44,27,17
783,1783,9924,4426,22,9,13
784,1784,9923,4427,85,41,44
785,1785,9924,4433,424,197,227
786,1786,9910,4446,132,18,114
787,1787,9910,4447,519,267,252
788,1788,9911,4437,436,182,254
789,1789,9903,4445,199,46,153
790,1790,9933,4434,122,54,68
791,1791,9941,4445,68,33,35
792,1792,9901,4445,150,83,67
793,1793,9905,4437,143,71,72
794,1794,9940,4460,104,51,53
795,1795,9926,4465,207,114,93
796,1796,9927,4467,11,1,10
797,1797,9922,4457,195,77,118
798,1798,9938,4441,50,7,43
799,1799,9934,4456,233,92,141
800,1800,9913,4447,831,206,625
801,1801,9927,4434,657,248,409
802,1802,9915,4462,212,89,123
803,1803,9914,4465,142,85,57
804,1804,9915,4466,11,10,1
805,1805,9915,4463,635,320,315
806,1806,9914,4462,206,142,64
807,1807,9926,4466,84,15,69
808,1808,9933,4446,141,69,72
809,1809,9926,4454,351,155,196
810,1810,9926,4469,38,16,22
811,1811,9947,4439,231,105,126
812,1812,9903,4444,174,63,111
813,1813,9910,4460,279,142,137
814,1814,9923,4459,358,153,205
815,1815,9902,4476,1,1,0
816,1816,9962,4447,5,0,5
817,1817,9920,4431,274,113,161
818,1818,9912,4457,379,234,145
819,1819,9916,4430,8,1,7
820,1820,9908,4445,673,258,415
821,1821,9911,4436,935,630,305
822,1822,9945,4438,69,26,43
823,1823,9943,4465,12,8,4
824,1824,9932,4455,43,25,18
825,1825,9919,4461,979,468,511
826,1826,9928,4431,402,167,235
827,1827,9933,4452,441,223,218
828,1828,9923,4461,107,26,81
829,1829,9914,4473,3,2,1
830,1830,9920,4428,293,167,126
831,1831,9936,4444,92,31,61
832,1832,9935,4446,595,281,314
833,1833,9939,4462,35,5,30
834,1834,9933,4429,665,293,372
835,1835,9934,4427,63,18,45
836,1836,9934,4446,618,299,319
837,1837,9921,4428,129,20,109
838,1838,9922,4432,150,56,94
839,1839,9920,4427,90,29,61
840,1840,9917,4419,6,3,3
841,1841,9914,4418,3,0,3
842,1842,9909,4439,38,0,38
843,1843,9926,4462,539,155,384
844,1844,9919,4463,75,17,58
845,1845,9926,4472,84,44,40
846,1846,9925,4472,40,17,23
847,1847,9922,4462,227,51,176
848,1848,9922,4463,157,70,87
849,1849,9919,4423,245,121,124
850,1850,9927,4471,10,2,8
851,1851,9921,4430,69,5,64
852,1852,9930,4431,110,55,55
853,1853,9913,4446,880,441,439
854,1854,9910,4445,126,50,76
855,1855,9920,4426,309,208,101
856,1856,9911,4435,178,53,125
857,1857,9907,4433,131,36,95
858,1858,9918,4452,1371,572,799
859,1859,9930,4435,626,269,357
860,1860,9925,4430,453,252,201
861,1861,9931,4420,50,37,13
862,1862,9914,4434,757,280,477
863,1863,9935,4428,391,208,183
864,1864,9914,4450,229,101,128
865,1865,9936,4450,92,31,61
866,1866,9935,4453,34,8,26
867,1867,9919,4427,435,229,206
868,1868,9920,4429,486,284,202
869,1869,9935,4429,396,189,207
870,1870,9913,4450,147,8,139
871,1871,9908,4449,383,148,235
872,1872,9911,4449,509,272,237
873,1873,9909,4463,80,25,55
874,1874,9934,4450,111,29,82
875,1875,9917,4465,20,5,15
876,1876,9913,4467,128,87,41
877,1877,9942,4442,371,241,130
878,1878,9948,4441,47,12,35
879,1879,9937,4462,254,173,81
880,1880,9902,4447,106,16,90
881,1881,9936,4463,76,43,33
882,1882,9925,4458,512,217,295
883,1883,9935,4445,151,26,125
884,1884,9934,4438,609,275,334
885,1885,9933,4428,218,84,134
886,1886,9927,4455,541,332,209
887,1887,9930,4455,172,42,130
888,1888,9920,4462,266,76,190
889,1889,9917,4462,200,34,166
890,1890,9922,4459,401,175,226
891,1891,9927,4461,244,45,199
892,1892,9941,4460,128,41,87
893,1893,9925,4433,546,331,215
894,1894,9930,4461,33,11,22
895,1895,9934,4461,81,64,17
896,1896,9928,4457,54,12,42
897,1897,9939,4452,38,19,19
898,1898,9930,4459,19,10,9
899,1899,9940,4441,42,20,22
900,1900,9935,4457,12,3,9
901,1901,9933,4456,197,65,132
902,1902,9937,4449,151,50,101
903,1903,9915,4460,13,7,6
904,1904,9929,4434,597,287,310
905,1905,9907,4440,46,16,30
906,1906,9927,4454,240,117,123
907,1907,9923,4430,342,168,174
908,1908,9929,4433,396,189,207
909,1909,9911,4452,194,64,130
910,1910,9918,4462,316,111,205
911,1911,9939,4458,113,62,51
912,1912,9905,4443,178,33,145
913,1913,9931,4433,366,161,205
914,1914,9933,4430,769,434,335
915,1915,9912,4468,32,16,16
916,1916,9920,4422,331,150,181
917,1917,9926,4464,154,50,104
918,1918,9918,4425,125,70,55
919,1919,9928,4479,4,1,3
920,1920,9909,4443,158,21,137
921,1921,9937,4432,70,20,50
922,1922,9929,4432,244,109,135
923,1923,9901,4446,31,8,23
924,1924,9924,4462,27,8,19
925,1925,9902,4422,47,13,34
926,1926,9899,4422,2,1,1
927,1927,9908,4433,261,165,96
928,1928,9941,4459,111,56,55
929,1929,9941,4450,38,14,24
930,1930,9903,4424,51,28,23
931,1931,9902,4436,8,1,7
932,1932,9942,4440,148,70,78
933,1933,9941,4442,531,294,237
934,1934,9909,4462,36,11,25
935,1935,9911,4461,257,147,110
936,1936,9912,4459,204,105,99
937,1937,9935,4447,68,19,49
938,1938,9950,4442,15,3,12
939,1939,9919,4424,358,177,181
940,1940,9911,4457,183,92,91
941,1941,9908,4458,13,4,9
942,1942,9911,4458,254,83,171
943,1943,9927,4458,66,16,50
944,1944,9943,4438,21,2,19
945,1945,9941,4440,68,31,37
946,1946,9905,4438,58,24,34
947,1947,9936,4427,190,90,100
948,1948,9915,4430,42,13,29
949,1949,9934,4431,688,332,356
950,1950,9926,4433,223,69,154
951,1951,9932,4429,353,181,172
952,1952,9939,4422,38,24,14
953,1953,9926,4427,12,0,12
954,1954,9937,4444,216,79,137
955,1955,9912,4462,82,9,73
956,1956,9900,4442,76,17,59
957,1957,9934,4449,183,73,110
958,1958,9938,4445,91,21,70
959,1959,9926,4428,258,115,143
960,1960,9912,4448,57,4,53
961,1961,9934,4447,167,64,103
962,1962,9911,4450,277,122,155
963,1963,9942,4443,261,59,202
964,1964,9913,4427,36,16,20
965,1965,9943,4444,44,15,29
966,1966,9942,4444,144,62,82
967,1967,9935,4452,90,24,66
968,1968,9926,4431,268,55,213
969,1969,9939,4423,19,10,9
970,1970,9937,4423,117,62,55
971,1971,9937,4424,48,18,30
972,1972,9939,4437,103,48,55
973,1973,9939,4436,49,7,42
974,1974,9932,4446,308,148,160
975,1975,9925,4454,94,44,50
976,1976,9941,4466,22,10,12
977,1977,9942,4467,3,0,3
978,1978,9938,4465,14,5,9
979,1979,9943,4466,4,2,2
980,1980,9936,4464,17,4,13
981,1981,9907,4452,65,17,48
982,1982,9915,4431,405,191,214
983,1983,9942,4446,22,1,21
984,1984,9910,4437,189,51,138
985,1985,9915,4428,493,223,270
986,1986,9913,4448,132,9,123
987,1987,9911,4434,1006,489,517
988,1988,9921,4462,286,104,182
989,1989,9911,4466,60,26,34
990,1990,9919,4431,172,53,119
991,1991,9930,4432,69,22,47
992,1992,9946,4438,30,8,22
993,1993,9947,4440,82,38,44
994,1994,9919,4436,470,72,398
995,1995,9900,4441,71,35,36
996,1996,9911,4448,402,168,234
997,1997,9911,4439,174,26,148
998,1998,9921,4463,19,10,9
999,1999,9897,4412,2,2,0
1000,2000,9898,4415,5,1,4
1001,2001,9923,4428,53,20,33
1002,2002,9922,4455,96,54,42
1003,2003,9909,4438,37,10,27
1004,2004,9918,4431,113,11,102
1005,2005,9938,4444,352,167,185
1006,2006,9906,4457,50,30,20
1007,2007,9906,4459,54,13,41
1008,2008,9899,4448,141,58,83
1009,2009,9899,4446,287,70,217
1010,2010,9944,4440,57,27,30
1011,2011,9911,4438,598,209,389
1012,2012,9938,4458,130,65,65
1013,2013,9905,4431,84,22,62
1014,2014,9898,4446,78,14,64
1015,2015,9904,4425,44,18,26
1016,2016,9916,4426,135,48,87
1017,2017,9913,4469,7,1,6
1018,2018,9909,4456,77,18,59
1019,2019,9910,4457,67,38,29
1020,2020,9928,4433,115,64,51
1021,2021,9940,4458,63,34,29
1022,2022,9910,4448,43,9,34
1023,2023,9934,4432,113,42,71
1024,2024,9935,4427,383,193,190
1025,2025,9921,4433,229,151,78
1026,2026,9901,4448,104,17,87
1027,2027,9945,4439,69,27,42
1028,2028,9936,4449,66,18,48
1029,2029,9934,4452,201,78,123
1030,2030,9916,4429,65,6,59
1031,2031,9910,4474,34,16,18
1032,2032,9916,4463,89,61,28
1033,2033,9938,4450,10,2,8
1034,2034,9902,4462,11,3,8
1035,2035,9905,4458,20,9,11
1036,2036,9932,4436,329,149,180
1037,2037,9925,4465,80,45,35
1038,2038,9916,4472,2,0,2
1039,2039,9934,4451,95,41,54
1040,2040,9928,4453,120,47,73
1041,2041,9928,4425,4,0,4
1042,2042,9910,4462,53,4,49
1043,2043,9936,4448,210,60,150
1044,2044,9914,4458,52,23,29
1045,2045,9929,4431,565,254,311
1046,2046,9927,4465,44,23,21
1047,2047,9943,4442,155,68,87
1048,2048,9910,4477,46,14,32
1049,2049,9917,4431,76,30,46
1050,2050,9916,4432,37,12,25
1051,2051,9944,4451,33,15,18
1052,2052,9931,4429,136,50,86
1053,2053,9938,4426,35,7,28
1054,2054,9937,4431,25,12,13
1055,2055,9907,4431,121,53,68
1056,2056,9933,4455,72,46,26
1057,2057,9917,4463,118,33,85
1058,2058,9943,4437,8,5,3
1059,2059,9933,4457,20,2,18
1060,2060,9935,4437,36,5,31
1061,2061,9939,4453,46,7,39
1062,2062,9905,4445,202,46,156
1063,2063,9899,4447,96,22,74
1064,2064,9898,4452,16,6,10
1065,2065,9917,4429,90,27,63
1066,2066,9928,4426,19,11,8
1067,2067,9934,4416,8,3,5
1068,2068,9943,4459,13,9,4
1069,2069,9939,4450,8,7,1
1070,2070,9941,4436,22,5,17
1071,2071,9944,4455,47,7,40
1072,2072,9948,4456,15,5,10
1073,2073,9953,4457,1,0,1
1074,2074,9908,4431,94,60,34
1075,2075,9909,4431,31,7,24
1076,2076,9930,4430,137,51,86
1077,2077,9903,4447,9,2,7
1078,2078,9907,4447,92,29,63
1079,2079,9906,4441,80,9,71
1080,2080,9913,4470,14,7,7
1081,2081,9935,4435,69,12,57
1082,2082,9913,4438,357,179,178
1083,2083,9937,4438,115,47,68
1084,2084,9909,4444,298,63,235
1085,2085,9906,4428,8,3,5
1086,2086,9907,4429,29,14,15
1087,2087,9908,4435,400,212,188
1088,2088,9909,4457,68,39,29
1089,2089,9920,4458,147,17,130
1090,2090,9923,4424,34,4,30
1091,2091,9909,4440,386,77,309
1092,2092,9910,4451,172,32,140
1093,2093,9931,4456,22,7,15
1094,2094,9897,4411,1,0,1
1095,2095,9911,4473,8,4,4
1096,2096,9911,4468,6,1,5
1097,2097,9912,4469,33,19,14
1098,2098,9947,4442,106,40,66
1099,2099,9913,4463,7,0,7
1100,2100,9908,4461,12,1,11
1101,2101,9925,4464,120,77,43
1102,2102,9923,4463,44,21,23
1103,2103,9943,4441,7,0,7
1104,2104,9921,4418,1,0,1
1105,2105,9918,4410,15,6,9
1106,2106,9922,4464,101,39,62
1107,2107,9923,4429,82,41,41
1108,2108,9896,4445,24,6,18
1109,2109,9945,4483,4,1,3
1110,2110,9943,4482,1,0,1
1111,2111,9930,4433,90,9,81
1112,2112,9909,4423,6,4,2
1113,2113,9909,4425,14,6,8
1114,2114,9937,4427,51,27,24
1115,2115,9937,4433,28,9,19
1116,2116,9952,4447,9,2,7
1117,2117,9914,4471,8,0,8
1118,2118,9913,4468,57,34,23
1119,2119,9937,4441,74,22,52
1120,2120,9937,4440,16,8,8
1121,2121,9922,4460,66,5,61
1122,2122,9931,4431,211,100,111
1123,2123,9930,4421,59,42,17
1124,2124,9923,4432,52,11,41
1125,2125,9908,4440,213,37,176
1126,2126,9929,4462,26,3,23
1127,2127,9909,4450,120,12,108
1128,2128,9938,4461,238,161,77
1129,2129,9904,4422,10,2,8
1130,2130,9955,4445,5,1,4
1131,2131,9936,4456,61,29,32
1132,2132,9915,4459,105,13,92
1133,2133,9924,4421,8,5,3
1134,2134,9949,4441,38,14,24
1135,2135,9929,4426,83,33,50
1136,2136,9949,4438,70,36,34
1137,2137,9957,4434,1,0,1
1138,2138,9936,4428,115,43,72
1139,2139,9935,4426,65,23,42
1140,2140,9904,4430,45,10,35
1141,2141,9935,4432,128,51,77
1142,2142,9931,4457,36,4,32
1143,2143,9900,4444,204,35,169
1144,2144,9933,4462,45,32,13
1145,2145,9923,4419,4,0,4
1146,2146,9940,4446,14,8,6
1147,2147,9922,4429,185,87,98
1148,2148,9922,4423,31,8,23
1149,2149,9950,4446,12,0,12
1150,2150,9921,4458,73,27,46
1151,2151,9944,4439,4,0,4
1152,2152,9937,4469,11,3,8
1153,2153,9936,4434,43,10,33
1154,2154,9935,4451,41,5,36
1155,2155,9907,4441,58,2,56
1156,2156,9947,4438,72,24,48
1157,2157,9950,4434,7,0,7
1158,2158,9945,4443,118,37,81
1159,2159,9914,4427,59,38,21
1160,2160,9909,4446,33,7,26
1161,2161,9903,4430,19,10,9
1162,2162,9928,4454,96,50,46
1163,2163,9937,4452,6,0,6
1164,2164,9925,4428,88,23,65
1165,2165,9936,4446,149,80,69
1166,2166,9907,4457,76,33,43
1167,2167,9907,4434,237,101,136
1168,2168,9906,4446,72,9,63
1169,2169,9917,4425,90,19,71
1170,2170,9938,4455,110,69,41
1171,2171,9934,4454,67,31,36
1172,2172,9921,4425,78,20,58
1173,2173,9896,4420,13,4,9
1174,2174,9922,4458,64,6,58
1175,2175,9933,4454,51,9,42
1176,2176,9936,4453,42,16,26
1177,2177,9937,4425,296,152,144
1178,2178,9934,4434,169,50,119
1179,2179,9912,4461,144,83,61
1180,2180,9936,4439,52,7,45
1181,2181,9933,4459,19,3,16
1182,2182,9934,4459,10,4,6
1183,2183,9937,4458,6,1,5
1184,2184,9922,4426,68,6,62
1185,2185,9940,4450,21,15,6
1186,2186,9918,4430,88,40,48
1187,2187,9916,4410,30,20,10
1188,2188,9946,4445,22,9,13
1189,2189,9925,4468,12,7,5
1190,2190,9936,4435,51,16,35
1191,2191,9915,4427,51,22,29
1192,2192,9905,4426,68,31,37
1193,2193,9942,4441,214,83,131
1194,2194,9932,4434,56,8,48
1195,2195,9946,4442,87,35,52
1196,2196,9900,4440,35,18,17
1197,2197,9948,4440,68,18,50
1198,2198,9900,4443,48,16,32
1199,2199,9929,4429,28,9,19
1200,2200,9929,4430,272,116,156
1201,2201,9929,4423,31,19,12
1202,2202,9915,4469,24,10,14
1203,2203,9913,4466,252,152,100
1204,2204,9900,4462,35,7,28
1205,2205,9902,4458,6,4,2
1206,2206,9901,4462,107,49,58
1207,2207,9927,4464,71,38,33
1208,2208,9925,4473,36,17,19
1209,2209,9928,4472,4,3,1
1210,2210,9948,4439,32,9,23
1211,2211,9936,4451,5,1,4
1212,2212,9898,4445,81,15,66
1213,2213,9938,4432,33,9,24
1214,2214,9916,4424,16,8,8
1215,2215,9912,4476,28,8,20
1216,2216,9898,4444,6,0,6
1217,2217,9936,4442,188,93,95
1218,2218,9938,4425,150,63,87
1219,2219,9939,4424,14,8,6
1220,2220,9934,4426,49,20,29
1221,2221,9913,4425,6,0,6
1222,2222,9906,4430,22,12,10
1223,2223,9946,4439,25,6,19
1224,2224,9941,4441,28,3,25
1225,2225,9909,4445,207,94,113
1226,2226,9919,4434,114,2,112
1227,2227,9931,4426,10,4,6
1228,2228,9918,4421,15,6,9
1229,2229,9905,4472,11,4,7
1230,2230,9944,4438,12,3,9
1231,2231,9942,4456,18,6,12
1232,2232,9913,4452,86,20,66
1233,2233,9899,4416,2,0,2
1234,2234,9916,4464,22,6,16
1235,2235,9938,4464,85,36,49
1236,2236,9932,4471,1,1,0
1237,2237,9930,4472,8,3,5
1238,2238,9941,4444,361,182,179
1239,2239,9940,4440,22,10,12
1240,2240,9962,4445,1,0,1
1241,2241,9928,4432,182,60,122
1242,2242,9935,4425,12,3,9
1243,2243,9933,4432,56,14,42
1244,2244,9923,4458,32,5,27
1245,2245,9923,4460,33,9,24
1246,2246,9932,4427,12,7,5
1247,2247,9936,4433,101,27,74
1248,2248,9933,4426,52,10,42
1249,2249,9942,4415,1,1,0
1250,2250,9940,4415,1,0,1
1251,2251,9938,4463,82,40,42
1252,2252,9933,4431,206,98,108
1253,2253,9938,4436,36,10,26
1254,2254,9938,4437,88,32,56
1255,2255,9939,4460,75,38,37
1256,2256,9906,4434,34,17,17
1257,2257,9924,4461,71,18,53
1258,2258,9901,4441,15,4,11
1259,2259,9910,4450,69,32,37
1260,2260,9940,4431,13,0,13
1261,2261,9939,4433,3,0,3
1262,2262,9946,4444,100,57,43
1263,2263,9940,4449,148,115,33
1264,2264,9941,4456,43,28,15
1265,2265,9934,4457,27,14,13
1266,2266,9906,4440,88,24,64
1267,2267,9922,4431,207,77,130
1268,2268,9905,4427,63,26,37
1269,2269,9935,4433,31,7,24
1270,2270,9904,4458,30,8,22
1271,2271,9910,4456,94,15,79
1272,2272,9941,4469,2,0,2
1273,2273,9918,4465,13,3,10
1274,2274,9908,4434,308,166,142
1275,2275,9928,4429,20,2,18
1276,2276,9936,4432,49,20,29
1277,2277,9925,4474,5,2,3
1278,2278,9938,4453,81,51,30
1279,2279,9943,4450,2,1,1
1280,2280,9904,4443,143,73,70
1281,2281,9940,4437,87,31,56
1282,2282,9942,4447,21,1,20
1283,2283,9949,4444,39,13,26
1284,2284,9948,4444,28,6,22
1285,2285,9945,4466,14,4,10
1286,2286,9910,4475,32,16,16
1287,2287,9902,4468,10,3,7
1288,2288,9935,4441,116,45,71
1289,2289,9933,4433,99,31,68
1290,2290,9937,4450,11,1,10
1291,2291,9916,4428,107,34,73
1292,2292,9921,4426,44,22,22
1293,2293,9906,4447,135,28,107
1294,2294,9924,4456,26,8,18
1295,2295,9919,4454,86,27,59
1296,2296,9911,4459,179,45,134
1297,2297,9934,4439,167,20,147
1298,2298,9937,4454,95,39,56
1299,2299,9943,4456,76,54,22
1300,2300,9916,4453,18,3,15
1301,2301,9901,4449,15,1,14
1302,2302,9905,4430,16,5,11
1303,2303,9936,4431,62,32,30
1304,2304,9892,4491,2,2,0
1305,2305,9893,4490,1,0,1
1306,2306,9937,4445,55,19,36
1307,2307,9918,4422,55,19,36
1308,2308,9930,4458,12,1,11
1309,2309,9902,4429,11,1,10
1310,2310,9927,4433,113,29,84
1311,2311,9934,4435,51,14,37
1312,2312,9931,4455,72,35,37
1313,2313,9910,4476,60,17,43
1314,2314,9929,4466,4,1,3
1315,2315,9912,4465,47,10,37
1316,2316,9913,4477,13,2,11
1317,2317,9942,4457,124,74,50
1318,2318,9932,4466,25,17,8
1319,2319,9937,4464,183,83,100
1320,2320,9932,4462,23,14,9
1321,2321,9939,4467,4,1,3
1322,2322,9903,4437,17,10,7
1323,2323,9902,4440,15,7,8
1324,2324,9914,4464,80,12,68
1325,2325,9929,4457,6,1,5
1326,2326,9936,4441,61,11,50
1327,2327,9946,4443,94,21,73
1328,2328,9940,4430,62,23,39
1329,2329,9906,4458,21,8,13
1330,2330,9932,4428,55,30,25
1331,2331,9940,4466,12,10,2
1332,2332,9933,4476,3,1,2
1333,2333,9913,4433,77,15,62
1334,2334,9902,4445,218,132,86
1335,2335,9949,4442,20,8,12
1336,2336,9943,4443,102,42,60
1337,2337,9958,4436,3,1,2
1338,2338,9917,4428,58,26,32
1339,2339,9924,4457,45,7,38
1340,2340,9902,4424,74,32,42
1341,2341,9913,4426,7,0,7
1342,2342,9921,4423,50,14,36
1343,2343,9903,4443,23,1,22
1344,2344,9917,4427,73,28,45
1345,2345,9917,4421,1,1,0
1346,2346,9929,4461,22,12,10
1347,2347,9926,4424,1,0,1
1348,2348,9927,4429,27,1,26
1349,2349,9957,4433,6,5,1
1350,2350,9952,4437,8,4,4
1351,2351,9947,4465,30,11,19
1352,2352,9937,4457,6,0,6
1353,2353,9912,4477,22,9,13
1354,2354,9921,4421,17,5,12
1355,2355,9935,4436,114,58,56
1356,2356,9947,4456,31,12,19
1357,2357,9909,4426,35,19,16
1358,2358,9930,4456,74,22,52
1359,2359,9902,4463,2,0,2
1360,2360,9912,4478,2,0,2
1361,2361,9906,4436,32,11,21
1362,2362,9903,4436,7,1,6
1363,2363,9937,4435,34,17,17
1364,2364,9939,4461,55,27,28
1365,2365,9921,4464,10,2,8
1366,2366,9922,4425,2,1,1
1367,2367,9905,4433,15,8,7
1368,2368,9932,4431,40,11,29
1369,2369,9931,4432,11,0,11
1370,2370,9940,4463,32,16,16
1371,2371,9916,4460,60,13,47
1372,2372,9911,4462,30,8,22
1373,2373,9957,4432,1,1,0
1374,2374,9942,4461,4,4,0
1375,2375,9927,4432,51,7,44
1376,2376,9901,4430,1,0,1
1377,2377,9901,4420,6,5,1
1378,2378,9899,4421,7,2,5
1379,2379,9939,4449,63,34,29
1380,2380,9907,4448,10,8,2
1381,2381,9944,4454,5,0,5
1382,2382,9915,4461,47,12,35
1383,2383,9904,4427,8,3,5
1384,2384,9908,4465,10,2,8
1385,2385,9912,4463,20,5,15
1386,2386,9902,4467,18,2,16
1387,2387,9916,4427,55,20,35
1388,2388,9914,4466,18,1,17
1389,2389,9922,4427,21,4,17
1390,2390,9940,4447,31,17,14
1391,2391,9941,4438,5,1,4
1392,2392,9903,4448,3,1,2
1393,2393,9918,4413,5,5,0
1394,2394,9914,4425,40,14,26
1395,2395,9933,4463,61,44,17
1396,2396,9909,4461,24,4,20
1397,2397,9925,4425,16,4,12
1398,2398,9944,4471,9,3,6
1399,2399,9907,4437,4,0,4
1400,2400,9926,4421,7,1,6
1401,2401,9886,4416,1,0,1
1402,2402,9940,4445,50,9,41
1403,2403,9910,4463,6,1,5
1404,2404,9908,4460,6,4,2
1405,2405,9948,4438,26,9,17
1406,2406,9911,4476,47,13,34
1407,2407,9917,4426,68,18,50
1408,2408,9948,4414,1,0,1
1409,2409,9929,4424,17,11,6
1410,2410,9918,4463,47,19,28
1411,2411,9908,4439,54,7,47
1412,2412,9906,4456,7,1,6
1413,2413,9912,4451,18,7,11
1414,2414,9942,4438,4,2,2
1415,2415,9960,4426,1,0,1
1416,2416,9940,4419,13,11,2
1417,2417,9932,4454,41,15,26
1418,2418,9939,4439,13,4,9
1419,2419,9930,4422,49,31,18
1420,2420,9946,4437,12,4,8
1421,2421,9936,4436,27,10,17
1422,2422,9906,4429,11,7,4
1423,2423,9908,4426,12,4,8
1424,2424,9896,4422,5,2,3
1425,2425,9909,4452,192,37,155
1426,2426,9947,4458,21,15,6
1427,2427,9951,4423,1,0,1
1428,2428,9921,4419,5,4,1
1429,2429,9939,4446,26,10,16
1430,2430,9900,4431,11,5,6
1431,2431,9901,4431,9,7,2
1432,2432,9903,4466,12,4,8
1433,2433,9915,4480,13,7,6
1434,2434,9900,4447,81,8,73
1435,2435,9904,4460,48,32,16
1436,2436,9958,4446,11,0,11
1437,2437,9947,4459,10,7,3
1438,2438,9948,4466,4,1,3
1439,2439,9946,4471,4,1,3
1440,2440,9945,4471,10,4,6
1441,2441,9891,4397,1,0,1
1442,2442,9936,4430,39,18,21
1443,2443,9930,4467,7,2,5
1444,2444,9932,4456,20,4,16
1445,2445,9930,4462,18,13,5
1446,2446,9948,4484,5,0,5
1447,2447,9947,4441,56,17,39
1448,2448,9911,4474,32,15,17
1449,2449,9908,4472,3,1,2
1450,2450,9904,4459,5,3,2
1451,2451,9914,4428,21,1,20
1452,2452,9896,4444,16,2,14
1453,2453,9929,4459,4,2,2
1454,2454,9933,4461,15,13,2
1455,2455,9938,4457,71,38,33
1456,2456,9924,4472,32,13,19
1457,2457,9915,4471,1,1,0
1458,2458,9936,4452,41,3,38
1459,2459,9944,4465,4,3,1
1460,2460,9940,4465,5,3,2
1461,2461,9912,4433,25,2,23
1462,2462,9910,4443,68,13,55
1463,2463,9950,4451,3,1,2
1464,2464,9935,4460,19,5,14
1465,2465,9943,4439,15,1,14
1466,2466,9924,4455,41,23,18
1467,2467,9914,4459,48,13,35
1468,2468,9913,4424,6,0,6
1469,2469,9902,4448,26,6,20
1470,2470,9947,4470,7,5,2
1471,2471,9917,4417,7,4,3
1472,2472,9936,4454,26,7,19
1473,2473,9902,4442,4,1,3
1474,2474,9944,4483,1,0,1
1475,2475,9924,4471,6,2,4
1476,2476,9908,4477,4,1,3
1477,2477,9909,4436,43,7,36
1478,2478,9938,4427,25,9,16
1479,2479,9933,4427,88,42,46
1480,2480,9913,4430,9,3,6
1481,2481,9938,4422,25,9,16
1482,2482,9946,4467,56,16,40
1483,2483,9941,4465,7,7,0
1484,2484,9945,4467,19,6,13
1485,2485,9918,4400,1,0,1
1486,2486,9918,4418,15,10,5
1487,2487,9923,4456,16,3,13
1488,2488,9911,4433,14,1,13
1489,2489,9918,4411,4,3,1
1490,2490,9901,4424,6,4,2
1491,2491,9947,4464,11,6,5
1492,2492,9945,4456,26,15,11
1493,2493,9908,4489,4,0,4
1494,2494,9915,4465,43,9,34
1495,2495,9935,4466,6,3,3
1496,2496,9936,4458,50,31,19
1497,2497,9911,4470,11,5,6
1498,2498,9916,4465,63,18,45
1499,2499,9938,4434,4,0,4
1500,2500,9920,4420,20,11,9
1501,2501,9915,4424,24,6,18
1502,2502,9924,4416,1,1,0
1503,2503,9917,4422,5,2,3
1504,2504,9944,4443,65,26,39
1505,2505,9898,4431,2,0,2
1506,2506,9941,4417,5,2,3
1507,2507,9914,4426,13,3,10
1508,2508,9909,4458,3,1,2
1509,2509,9939,4426,18,6,12
1510,2510,9956,4450,6,0,6
1511,2511,9919,4470,1,0,1
1512,2512,9912,4456,30,1,29
1513,2513,9939,4466,8,4,4
1514,2514,9937,4434,25,6,19
1515,2515,9930,4425,12,0,12
1516,2516,9931,4465,11,4,7
1517,2517,9942,4455,7,2,5
1518,2518,9943,4455,8,2,6
1519,2519,9934,4463,14,6,8
1520,2520,9943,4430,1,0,1
1521,2521,9944,4436,4,2,2
1522,2522,9897,4446,11,3,8
1523,2523,9926,4473,17,6,11
1524,2524,9923,4472,17,1,16
1525,2525,9910,4455,6,0,6
1526,2526,9940,4451,6,0,6
1527,2527,9905,4446,39,7,32
1528,2528,9936,4424,19,7,12
1529,2529,9918,4428,53,28,25
1530,2530,9925,4469,35,23,12
1531,2531,9901,4479,7,0,7
1532,2532,9947,4437,22,11,11
1533,2533,9939,4431,15,6,9
1534,2534,9933,4413,1,1,0
1535,2535,9933,4416,1,1,0
1536,2536,9911,4453,38,8,30
1537,2537,9940,4436,13,5,8
1538,2538,9903,4429,8,3,5
1539,2539,9908,4437,6,1,5
1540,2540,9936,4447,22,3,19
1541,2541,9947,4475,7,3,4
1542,2542,9910,4459,55,23,32
1543,2543,9923,4455,14,5,9
1544,2544,9950,4438,20,12,8
1545,2545,9939,4445,18,2,16
1546,2546,9925,4467,22,8,14
1547,2547,9925,4421,25,11,14
1548,2548,9921,4465,18,0,18
1549,2549,9938,4480,1,1,0
1550,2550,9937,4465,15,4,11
1551,2551,9924,4460,9,3,6
1552,2552,9945,4499,1,0,1
1553,2553,9939,4428,1,0,1
1554,2554,9904,4438,43,22,21
1555,2555,9942,4439,59,36,23
1556,2556,9944,4452,3,0,3
1557,2557,9923,4415,2,1,1
1558,2558,9887,4421,4,2,2
1559,2559,9939,4454,38,17,21
1560,2560,9928,4465,43,21,22
1561,2561,9904,4432,44,8,36
1562,2562,9929,4456,20,6,14
1563,2563,9906,4466,2,2,0
1564,2564,9912,4464,2,0,2
1565,2565,9950,4436,33,10,23
1566,2566,9914,4469,25,15,10
1567,2567,9922,4421,18,6,12
1568,2568,9888,4493,1,1,0
1569,2569,9889,4499,1,0,1
1570,2570,9936,4478,2,1,1
1571,2571,9942,4463,4,0,4
1572,2572,9909,4459,42,5,37
1573,2573,9919,4464,22,4,18
1574,2574,9907,4430,52,25,27
1575,2575,9939,4435,40,13,27
1576,2576,9945,4452,2,0,2
1577,2577,9917,4415,2,1,1
1578,2578,9909,4427,37,13,24
1579,2579,9988,4470,1,0,1
1580,2580,9922,4417,1,0,1
1581,2581,9944,4487,3,1,2
1582,2582,9916,4469,13,1,12
1583,2583,9916,4417,6,1,5
1584,2584,9921,4455,91,19,72
1585,2585,9940,4423,13,3,10
1586,2586,9950,4443,45,16,29
1587,2587,9946,4462,1,0,1
1588,2588,9887,4422,3,1,2
1589,2589,9909,4428,13,5,8
1590,2590,9928,4424,6,0,6
1591,2591,9928,4427,45,12,33
1592,2592,9902,4425,8,5,3
1593,2593,9912,4427,15,11,4
1594,2594,9916,4423,3,0,3
1595,2595,9950,4439,23,7,16
1596,2596,9942,4465,20,16,4
1597,2597,9899,4450,1,0,1
1598,2598,9937,4456,38,8,30
1599,2599,9922,4428,47,4,43
1600,2600,9911,4478,11,3,8
1601,2601,9930,4465,13,11,2
1602,2602,9910,4468,6,0,6
1603,2603,9949,4446,10,1,9
1604,2604,9949,4445,32,11,21
1605,2605,9926,4470,35,20,15
1606,2606,9906,4438,11,0,11
1607,2607,9904,4439,40,23,17
1608,2608,9922,4465,71,20,51
1609,2609,9926,4477,4,2,2
1610,2610,9926,4475,2,0,2
1611,2611,9936,4455,143,115,28
1612,2612,9926,4432,29,6,23
1613,2613,9928,4464,5,2,3
1614,2614,9916,4425,7,1,6
1615,2615,9943,4436,18,7,11
1616,2616,9912,4474,3,0,3
1617,2617,9923,4425,24,4,20
1618,2618,9908,4455,3,0,3
1619,2619,9962,4444,1,0,1
1620,2620,9935,4449,11,1,10
1621,2621,9942,4451,1,0,1
1622,2622,9903,4446,42,5,37
1623,2623,9941,4463,12,1,11
1624,2624,9913,4451,19,1,18
1625,2625,9925,4462,17,3,14
1626,2626,9898,4426,3,0,3
1627,2627,9919,4415,2,0,2
1628,2628,9916,4418,4,4,0
1629,2629,9926,4415,9,1,8
1630,2630,9938,4456,23,12,11
1631,2631,9919,4465,9,3,6
1632,2632,9924,4470,8,4,4
1633,2633,9903,4432,60,29,31
1634,2634,9904,4457,6,1,5
1635,2635,9915,4474,12,7,5
1636,2636,9926,4426,18,3,15
1637,2637,9896,4431,2,2,0
1638,2638,9939,4430,16,5,11
1639,2639,9901,4440,32,13,19
1640,2640,9939,4440,21,8,13
1641,2641,9918,4415,21,3,18
1642,2642,9912,4452,73,19,54
1643,2643,9906,4462,31,19,12
1644,2644,9916,4473,5,2,3
1645,2645,9902,4431,5,5,0
1646,2646,9952,4434,5,3,2
1647,2647,9909,4476,19,10,9
1648,2648,9934,4462,36,24,12
1649,2649,9925,4470,10,6,4
1650,2650,9930,4426,9,1,8
1651,2651,9942,4452,11,1,10
1652,2652,9905,4435,30,22,8
1653,2653,9941,4447,21,4,17
1654,2654,9942,4450,3,2,1
1655,2655,9945,4451,5,2,3
1656,2656,9940,4455,9,3,6
1657,2657,9924,4465,9,3,6
1658,2658,9909,4424,5,5,0
1659,2659,9908,4416,1,0,1
1660,2660,9911,4418,1,1,0
1661,2661,9909,4419,5,1,4
1662,2662,9909,4418,1,1,0
1663,2663,9944,4456,48,19,29
1664,2664,9940,4457,32,17,15
1665,2665,9936,4465,25,9,16
1666,2666,9900,4463,8,2,6
1667,2667,9915,4468,17,3,14
1668,2668,9904,4473,1,0,1
1669,2669,9896,4410,1,1,0
1670,2670,9929,4428,29,13,16
1671,2671,9910,4473,22,9,13
1672,2672,9932,4459,14,3,11
1673,2673,9900,4458,3,2,1
1674,2674,9913,4459,20,0,20
1675,2675,9896,4414,6,2,4
1676,2676,9927,4472,2,2,0
1677,2677,9940,4462,11,5,6
1678,2678,9902,4433,2,0,2
1679,2679,9895,4445,5,0,5
1680,2680,9946,4476,3,1,2
1681,2681,9909,4477,22,6,16
1682,2682,9903,4425,14,7,7
1683,2683,9946,4424,12,5,7
1684,2684,9931,4421,9,4,5
1685,2685,9910,4464,2,0,2
1686,2686,9898,4447,22,0,22
1687,2687,9935,4438,60,23,37
1688,2688,9944,4444,17,10,7
1689,2689,9942,4445,22,4,18
1690,2690,9900,4449,5,0,5
1691,2691,9949,4443,60,26,34
1692,2692,9923,4462,26,2,24
1693,2693,9950,4445,25,10,15
1694,2694,9907,4456,4,0,4
1695,2695,9941,4439,10,4,6
1696,2696,9950,4447,6,3,3
1697,2697,9901,4458,2,1,1
1698,2698,9954,4436,9,7,2
1699,2699,9908,4436,9,0,9
1700,2700,9945,4468,4,0,4
1701,2701,9942,4433,4,1,3
1702,2702,9908,4453,25,12,13
1703,2703,9950,4435,8,2,6
1704,2704,9890,4419,6,4,2
1705,2705,9901,4421,5,1,4
1706,2706,9961,4447,4,0,4
1707,2707,9950,4440,8,4,4
1708,2708,9960,4446,2,0,2
1709,2709,9913,4431,3,0,3
1710,2710,9941,4437,17,3,14
1711,2711,9935,4463,8,3,5
1712,2712,9936,4459,19,10,9
1713,2713,9944,4470,8,3,5
1714,2714,9945,4484,3,2,1
1715,2715,9941,4423,24,6,18
1716,2716,9909,4430,11,2,9
1717,2717,9932,4432,71,36,35
1718,2718,9948,4450,2,2,0
1719,2719,9948,4451,5,2,3
1720,2720,9953,4443,4,2,2
1721,2721,9932,4419,2,2,0
1722,2722,9937,4429,39,9,30
1723,2723,9903,4467,7,2,5
1724,2724,9905,4461,1,0,1
1725,2725,9906,4460,19,11,8
1726,2726,9898,4409,1,0,1
1727,2727,9904,4426,49,34,15
1728,2728,9910,4432,1,0,1
1729,2729,9900,4461,6,2,4
1730,2730,9924,4466,3,1,2
1731,2731,9939,4427,10,3,7
1732,2732,9946,4436,8,2,6
1733,2733,9935,4434,28,9,19
1734,2734,9940,4453,26,3,23
1735,2735,9940,4452,35,9,26
1736,2736,9913,4464,5,0,5
1737,2737,9946,4446,13,2,11
1738,2738,9924,4458,20,7,13
1739,2739,9914,4429,23,2,21
1740,2740,9932,4406,1,1,0
1741,2741,9924,4425,11,0,11
1742,2742,9905,4428,8,5,3
1743,2743,9897,4421,5,4,1
1744,2744,9902,4427,2,0,2
1745,2745,9925,4423,13,6,7
1746,2746,9900,4471,1,0,1
1747,2747,9898,4449,12,6,6
1748,2748,9946,4465,23,3,20
1749,2749,9930,4468,3,1,2
1750,2750,9949,4464,2,0,2
1751,2751,9931,4422,4,1,3
1752,2752,9934,4424,8,1,7
1753,2753,9924,4424,6,0,6
1754,2754,9911,4451,45,18,27
1755,2755,9938,4418,3,0,3
1756,2756,9903,4426,6,2,4
1757,2757,9932,4457,14,1,13
1758,2758,9899,4417,7,6,1
1759,2759,9935,4424,4,0,4
1760,2760,9944,4437,6,5,1
1761,2761,9908,4430,5,2,3
1762,2762,9937,4418,1,0,1
1763,2763,9916,4459,12,4,8
1764,2764,9945,4472,4,1,3
1765,2765,9943,4451,6,4,2
1766,2766,9902,4460,2,0,2
1767,2767,9935,4468,2,1,1
1768,2768,9933,4471,10,1,9
1769,2769,9903,4460,6,3,3
1770,2770,9930,4460,7,4,3
1771,2771,9981,4473,1,0,1
1772,2772,9907,4469,1,0,1
1773,2773,9917,4464,7,1,6
1774,2774,9945,4459,10,4,6
1775,2775,9908,4466,8,5,3
1776,2776,9908,4464,15,10,5
1777,2777,9911,4471,10,7,3
1778,2778,9903,4423,28,11,17
1779,2779,9949,4463,2,0,2
1780,2780,9932,4467,34,26,8
1781,2781,9933,4425,8,0,8
1782,2782,9946,4468,2,0,2
1783,2783,9942,4458,16,6,10
1784,2784,9919,4466,4,0,4
1785,2785,9940,4417,8,8,0
1786,2786,9939,4420,1,0,1
1787,2787,9903,4463,5,2,3
1788,2788,9936,4425,14,2,12
1789,2789,9954,4446,1,0,1
1790,2790,9913,4432,56,5,51
1791,2791,9947,4453,4,3,1
1792,2792,9946,4451,5,3,2
1793,2793,9944,4450,1,0,1
1794,2794,9916,4421,2,1,1
1795,2795,9899,4441,8,1,7
1796,2796,9918,4399,1,1,0
1797,2797,9914,4401,1,0,1
1798,2798,9891,4492,9,1,8
1799,2799,9925,4463,23,13,10
1800,2800,9900,4425,4,2,2
1801,2801,9899,4423,1,1,0
1802,2802,9947,4436,2,0,2
1803,2803,9908,4462,4,1,3
1804,2804,9947,4448,3,0,3
1805,2805,9920,4415,5,2,3
1806,2806,9909,4455,6,0,6
1807,2807,9931,4425,2,1,1
1808,2808,9926,4468,4,1,3
1809,2809,9945,4475,2,1,1
1810,2810,9931,4458,2,0,2
1811,2811,9917,4471,8,5,3
1812,2812,9947,4472,3,1,2
1813,2813,9949,4439,11,3,8
1814,2814,9899,4440,20,11,9
1815,2815,9898,4439,8,3,5
1816,2816,9925,4419,6,5,1
1817,2817,9923,4420,13,3,10
1818,2818,9929,4467,61,37,24
1819,2819,9926,4410,2,2,0
1820,2820,9918,4419,6,2,4
1821,2821,9907,4475,3,0,3
1822,2822,9935,4465,13,8,5
1823,2823,9938,4423,7,4,3
1824,2824,9953,4437,7,5,2
1825,2825,9923,4421,15,9,6
1826,2826,9914,4430,11,0,11
1827,2827,9942,4436,6,1,5
1828,2828,9901,4443,5,0,5
1829,2829,9906,4431,43,14,29
1830,2830,9946,4472,2,1,1
1831,2831,9900,4422,12,4,8
1832,2832,9905,4421,3,1,2
1833,2833,9937,4461,3,0,3
1834,2834,9953,4446,6,2,4
1835,2835,9938,4466,1,0,1
1836,2836,9950,4448,3,0,3
1837,2837,9906,4461,3,1,2
1838,2838,9937,4415,1,0,1
1839,2839,9943,4468,5,3,2
1840,2840,9940,4464,2,2,0
1841,2841,9913,4418,4,1,3
1842,2842,9933,4419,2,0,2
1843,2843,9903,4428,2,2,0
1844,2844,9958,4448,1,0,1
1845,2845,9952,4446,17,7,10
1846,2846,9924,4420,1,0,1
1847,2847,9955,4477,1,1,0
1848,2848,9952,4474,1,0,1
1849,2849,9916,4475,2,0,2
1850,2850,9945,4480,1,0,1
1851,2851,9893,4441,10,1,9
1852,2852,9895,4439,1,1,0
1853,2853,9963,4492,3,2,1
1854,2854,9949,4461,2,1,1
1855,2855,9952,4457,4,2,2
1856,2856,9934,4464,6,4,2
1857,2857,9939,4438,22,11,11
1858,2858,9916,4476,1,0,1
1859,2859,9941,4468,15,8,7
1860,2860,9935,4454,38,22,16
1861,2861,9915,4420,4,1,3
1862,2862,9938,4429,4,2,2
1863,2863,9938,4430,13,0,13
1864,2864,9935,4448,35,12,23
1865,2865,9924,4427,5,1,4
1866,2866,9920,4410,2,1,1
1867,2867,9926,4408,1,1,0
1868,2868,9913,4471,7,1,6
1869,2869,9911,4475,24,7,17
1870,2870,9904,4441,8,1,7
1871,2871,9933,4418,2,1,1
1872,2872,9934,4417,1,0,1
1873,2873,9933,4424,18,7,11
1874,2874,9934,4465,8,5,3
1875,2875,9913,4417,1,0,1
1876,2876,9898,4450,7,4,3
1877,2877,9928,4467,6,3,3
1878,2878,9905,4441,14,0,14
1879,2879,9905,4436,24,1,23
1880,2880,9902,4441,1,0,1
1881,2881,9896,4417,3,0,3
1882,2882,9951,4439,7,1,6
1883,2883,9936,4422,1,1,0
1884,2884,9917,4398,7,3,4
1885,2885,9932,4416,1,1,0
1886,2886,9932,4420,1,0,1
1887,2887,9949,4479,1,1,0
1888,2888,9941,4476,1,0,1
1889,2889,9903,4461,1,0,1
1890,2890,9944,4486,4,1,3
1891,2891,9941,4435,15,5,10
1892,2892,9914,4470,4,2,2
1893,2893,9907,4478,2,0,2
1894,2894,9915,4477,1,1,0
1895,2895,9915,4475,2,0,2
1896,2896,9939,4419,2,1,1
1897,2897,9942,4468,4,0,4
1898,2898,9928,4428,11,2,9
1899,2899,9934,4425,20,6,14
1900,2900,9922,4422,8,2,6
1901,2901,9947,4473,3,3,0
1902,2902,9908,4417,3,2,1
1903,2903,9934,4423,1,0,1
1904,2904,9900,4472,3,2,1
1905,2905,9904,4465,2,1,1
1906,2906,9903,4481,1,0,1
1907,2907,9949,4457,4,3,1
1908,2908,9940,4448,4,0,4
1909,2909,9889,4410,1,1,0
1910,2910,9889,4409,1,0,1
1911,2911,9951,4445,8,5,3
1912,2912,9947,4474,3,2,1
1913,2913,9904,4472,8,0,8
1914,2914,9905,4457,9,2,7
1915,2915,9906,4463,23,21,2
1916,2916,9895,4420,4,2,2
1917,2917,9897,4444,7,1,6
1918,2918,9927,4470,16,7,9
1919,2919,9944,4467,7,2,5
1920,2920,9951,4437,13,8,5
1921,2921,9924,4459,15,7,8
1922,2922,9920,4465,8,0,8
1923,2923,9897,4417,4,0,4
1924,2924,9887,4425,1,0,1
1925,2925,9926,4416,4,2,2
1926,2926,9956,4445,1,0,1
1927,2927,9922,4424,6,1,5
1928,2928,9895,4422,1,1,0
1929,2929,9930,4474,1,0,1
1930,2930,9925,4417,8,7,1
1931,2931,9910,4430,1,0,1
1932,2932,9915,4425,14,1,13
1933,2933,9903,4440,5,2,3
1934,2934,9949,4437,11,2,9
1935,2935,9930,4429,15,0,15
1936,2936,9908,4473,2,1,1
1937,2937,9929,4464,16,7,9
1938,2938,9923,4465,8,2,6
1939,2939,9938,4452,4,3,1
1940,2940,9962,4431,2,2,0
1941,2941,9901,4419,2,2,0
1942,2942,9909,4466,7,3,4
1943,2943,9939,4429,1,1,0
1944,2944,9940,4432,8,1,7
1945,2945,9910,4425,2,1,1
1946,2946,9886,4408,3,0,3
1947,2947,9888,4421,4,1,3
1948,2948,9940,4438,20,7,13
1949,2949,9916,4477,1,0,1
1950,2950,9937,4428,25,5,20
1951,2951,9937,4421,2,0,2
1952,2952,9923,4464,23,13,10
1953,2953,9914,4412,1,0,1
1954,2954,9947,4444,12,5,7
1955,2955,9908,4419,1,1,0
1956,2956,9913,4479,1,1,0
1957,2957,9933,4417,6,6,0
1958,2958,9941,4454,6,2,4
1959,2959,9910,4416,1,0,1
1960,2960,9915,4418,2,1,1
1961,2961,9922,4419,3,0,3
1962,2962,9946,4459,2,1,1
1963,2963,9938,4467,9,3,6
1964,2964,9902,4464,2,0,2
1965,2965,9915,4422,6,2,4
1966,2966,9930,4469,2,1,1
1967,2967,9931,4467,2,0,2
1968,2968,9951,4443,4,3,1
1969,2969,9916,4422,6,1,5
1970,2970,9937,4455,35,25,10
1971,2971,9906,4435,3,3,0
1972,2972,9937,4453,12,6,6
1973,2973,9906,4474,1,0,1
1974,2974,9907,4458,5,0,5
1975,2975,9950,4421,1,1,0
1976,2976,9923,4469,4,1,3
1977,2977,9899,4431,2,1,1
1978,2978,9905,4480,1,0,1
1979,2979,9903,4464,9,2,7
1980,2980,9905,4459,11,5,6
1981,2981,9961,4502,1,1,0
1982,2982,9946,4453,7,4,3
1983,2983,9897,4452,16,11,5
1984,2984,9929,4419,1,0,1
1985,2985,9926,4423,5,3,2
1986,2986,9921,4472,3,2,1
1987,2987,9941,4420,1,0,1
1988,2988,9939,4463,6,2,4
1989,2989,9903,4422,11,2,9
1990,2990,9898,4417,2,1,1
1991,2991,9901,4423,11,2,9
1992,2992,9914,4431,18,7,11
1993,2993,9905,4456,4,1,3
1994,2994,9944,4457,5,2,3
1995,2995,9905,4478,2,1,1
1996,2996,9912,4414,1,0,1
1997,2997,9896,4416,3,2,1
1998,2998,9907,4432,6,1,5
1999,2999,9914,4480,3,1,2
2000,3000,9953,4455,5,0,5
2001,3001,9925,4420,4,3,1
2002,3002,9925,4424,7,7,0
2003,3003,9920,4464,6,1,5
2004,3004,9956,4407,2,0,2
2005,3005,9906,4433,9,0,9
2006,3006,9900,4446,11,1,10
2007,3007,9902,4443,14,1,13
2008,3008,9930,4470,3,1,2
2009,3009,9954,4443,1,0,1
2010,3010,9947,4450,1,0,1
2011,3011,9943,4440,8,3,5
2012,3012,9916,4419,4,0,4
2013,3013,9904,4433,7,0,7
2014,3014,9943,4470,4,0,4
2015,3015,9917,4399,1,0,1
2016,3016,9905,4469,1,0,1
2017,3017,9946,4469,2,1,1
2018,3018,9932,4469,2,0,2
2019,3019,9946,4433,7,0,7
2020,3020,9917,4410,12,4,8
2021,3021,9940,4435,9,3,6
2022,3022,9931,4464,6,2,4
2023,3023,9907,4428,5,0,5
2024,3024,9945,4477,2,1,1
2025,3025,9917,4473,1,1,0
2026,3026,9941,4429,1,0,1
2027,3027,9949,4474,4,1,3
2028,3028,9901,4459,11,6,5
2029,3029,9954,4468,4,0,4
2030,3030,9906,4424,8,4,4
2031,3031,9901,4436,2,1,1
2032,3032,9929,4427,9,1,8
2033,3033,9914,4423,7,3,4
2034,3034,9961,4494,2,1,1
2035,3035,9963,4496,1,0,1
2036,3036,9951,4440,2,0,2
2037,3037,9949,4449,1,1,0
2038,3038,9912,4432,5,1,4
2039,3039,9935,4459,6,3,3
2040,3040,9937,4468,3,1,2
2041,3041,9907,4449,5,0,5
2042,3042,9912,4475,11,4,7
2043,3043,9903,4416,1,0,1
2044,3044,9915,4414,1,0,1
2045,3045,9941,4434,19,5,14
2046,3046,9908,4424,4,3,1
2047,3047,9930,4428,3,0,3
2048,3048,9940,4422,5,2,3
2049,3049,9903,4459,5,1,4
2050,3050,9920,4472,3,0,3
2051,3051,9899,4452,6,2,4
2052,3052,9909,4433,2,0,2
2053,3053,9904,4449,2,0,2
2054,3054,9908,4459,1,0,1
2055,3055,9897,4439,5,2,3
2056,3056,9899,4439,2,2,0
2057,3057,9897,4413,5,4,1
2058,3058,9939,4425,7,0,7
2059,3059,9955,4433,1,0,1
2060,3060,9943,4445,4,2,2
2061,3061,9932,4412,1,0,1
2062,3062,9939,4464,5,0,5
2063,3063,9903,4421,4,0,4
2064,3064,9940,4467,15,11,4
2065,3065,9952,4461,2,2,0
2066,3066,9922,4418,1,1,0
2067,3067,9954,4445,1,1,0
2068,3068,9901,4437,8,1,7
2069,3069,9902,4435,3,0,3
2070,3070,9977,4425,2,1,1
2071,3071,9975,4424,2,1,1
2072,3072,9926,4419,1,0,1
2073,3073,9916,4466,6,1,5
2074,3074,9909,4478,5,1,4
2075,3075,9960,4436,6,1,5
2076,3076,9938,4424,18,6,12
2077,3077,9934,4476,2,1,1
2078,3078,9939,4421,15,4,11
2079,3079,9943,4446,3,1,2
2080,3080,9906,4471,3,1,2
2081,3081,9905,4471,1,0,1
2082,3082,9918,4414,2,0,2
2083,3083,9955,4439,3,2,1
2084,3084,9898,4416,1,1,0
2085,3085,9944,4468,3,2,1
2086,3086,9906,4437,4,2,2
2087,3087,9909,4474,2,0,2
2088,3088,9917,4470,3,2,1
2089,3089,9916,4470,8,1,7
2090,3090,9946,4452,5,2,3
2091,3091,9947,4457,6,1,5
2092,3092,9932,4461,2,0,2
2093,3093,9895,4444,12,0,12
2094,3094,9885,4420,1,0,1
2095,3095,9905,4424,10,2,8
2096,3096,9894,4440,1,0,1
2097,3097,9920,4417,4,1,3
2098,3098,9921,4417,2,0,2
2099,3099,9950,4444,2,1,1
2100,3100,9940,4456,9,6,3
2101,3101,9952,4436,7,2,5
2102,3102,9945,4490,3,2,1
2103,3103,9944,4435,2,0,2
2104,3104,9945,4457,3,1,2
2105,3105,9925,4409,2,2,0
2106,3106,9884,4422,1,0,1
2107,3107,9904,4428,5,1,4
2108,3108,9939,4434,1,0,1
2109,3109,9943,4426,1,0,1
2110,3110,9897,4415,1,1,0
2111,3111,9909,4482,1,1,0
2112,3112,9877,4403,1,0,1
2113,3113,9956,4440,1,0,1
2114,3114,9983,4480,1,1,0
2115,3115,9982,4482,1,0,1
2116,3116,9945,4465,5,3,2
2117,3117,9899,4453,8,0,8
2118,3118,9915,4419,5,1,4
2119,3119,9907,4427,1,0,1
2120,3120,9917,4416,7,6,1
2121,3121,9961,4431,2,1,1
2122,3122,9960,4432,1,0,1
2123,3123,9937,4467,1,0,1
2124,3124,9948,4453,1,1,0
2125,3125,9910,4466,3,0,3
2126,3126,9942,4430,4,0,4
2127,3127,9950,4466,3,1,2
2128,3128,9900,4430,2,0,2
2129,3129,9955,4435,2,1,1
2130,3130,9951,4399,1,0,1
2131,3131,9906,4419,3,1,2
2132,3132,9901,4444,23,2,21
2133,3133,9950,4456,1,1,0
2134,3134,9942,4434,2,1,1
2135,3135,9951,4438,2,0,2
2136,3136,9899,4477,1,0,1
2137,3137,9950,4428,4,2,2
2138,3138,9946,4429,1,0,1
2139,3139,9903,4419,2,1,1
2140,3140,9927,4419,2,0,2
2141,3141,9918,4471,9,2,7
2142,3142,9913,4429,8,2,6
2143,3143,9921,4415,2,0,2
2144,3144,9952,4462,2,0,2
2145,3145,9895,4423,2,0,2
2146,3146,9904,4424,6,1,5
2147,3147,9948,4468,1,0,1
2148,3148,9949,4467,2,1,1
2149,3149,9941,4451,1,0,1
2150,3150,9935,4464,6,1,5
2151,3151,9948,4465,10,6,4
2152,3152,9886,4417,1,0,1
2153,3153,9899,4458,3,1,2
2154,3154,9976,4426,1,0,1
2155,3155,9947,4455,3,0,3
2156,3156,9909,4453,17,10,7
2157,3157,9934,4419,1,1,0
2158,3158,9920,4416,4,0,4
2159,3159,9950,4468,1,0,1
2160,3160,9937,4411,1,0,1
2161,3161,9930,4423,2,0,2
2162,3162,9952,4443,1,1,0
2163,3163,9900,4479,3,1,2
2164,3164,9954,4441,3,1,2
2165,3165,9884,4423,2,0,2
2166,3166,9910,4427,3,0,3
2167,3167,9941,4432,2,0,2
2168,3168,9937,4422,7,2,5
2169,3169,9950,4467,5,1,4
2170,3170,9949,4469,2,2,0
2171,3171,9904,4419,1,0,1
2172,3172,9971,4443,1,0,1
2173,3173,9919,4474,1,0,1
2174,3174,9898,4424,2,0,2
2175,3175,9928,4458,10,2,8
2176,3176,9901,4442,6,1,5
2177,3177,9912,4425,2,1,1
2178,3178,9948,4467,1,1,0
2179,3179,9941,4462,2,0,2
2180,3180,9957,4448,3,0,3
2181,3181,9928,4421,2,2,0
2182,3182,9929,4420,3,0,3
2183,3183,9944,4462,1,0,1
2184,3184,9948,4443,22,10,12
2185,3185,9898,4453,4,0,4
2186,3186,9904,4440,3,0,3
2187,3187,9951,4481,1,1,0
2188,3188,9947,4476,3,1,2
2189,3189,9932,4433,12,2,10
2190,3190,9945,4463,2,0,2
2191,3191,9918,4416,7,4,3
2192,3192,9985,4463,1,1,0
2193,3193,9997,4470,1,0,1
2194,3194,9929,4460,9,1,8
2195,3195,9953,4417,1,1,0
2196,3196,9944,4489,4,1,3
2197,3197,9944,4411,1,0,1
2198,3198,9925,4471,3,1,2
2199,3199,9904,4421,6,1,5
2200,3200,9947,4445,6,0,6
2201,3201,9906,4426,11,4,7
2202,3202,9938,4451,6,5,1
2203,3203,9900,4460,18,5,13
2204,3204,9947,4485,4,1,3
2205,3205,9887,4408,2,1,1
2206,3206,9986,4468,2,1,1
2207,3207,9988,4472,1,0,1
2208,3208,9947,4447,3,3,0
2209,3209,9924,4428,7,0,7
2210,3210,9913,4423,1,0,1
2211,3211,9916,4416,1,0,1
2212,3212,9903,4435,1,0,1
2213,3213,9931,4428,1,0,1
2214,3214,9953,4436,3,1,2
2215,3215,9914,4457,2,0,2
2216,3216,9917,4392,1,0,1
2217,3217,9947,4491,1,1,0
2218,3218,9944,4485,1,0,1
2219,3219,9894,4489,2,0,2
2220,3220,9911,4464,8,0,8
2221,3221,9910,4458,16,3,13
2222,3222,9892,4419,1,1,0
2223,3223,9889,4419,6,0,6
2224,3224,9941,4433,8,3,5
2225,3225,9956,4435,1,1,0
2226,3226,9964,4494,1,0,1
2227,3227,9907,4473,2,0,2
2228,3228,9907,4460,1,1,0
2229,3229,9916,4393,1,1,0
2230,3230,9930,4420,8,1,7
2231,3231,9900,4453,7,1,6
2232,3232,9941,4453,2,0,2
2233,3233,9936,4429,10,1,9
2234,3234,9928,4419,3,1,2
2235,3235,9924,4415,1,0,1
2236,3236,9938,4473,3,1,2
2237,3237,9905,4439,5,2,3
2238,3238,9903,4441,1,0,1
2239,3239,9894,4408,2,1,1
2240,3240,9937,4470,3,1,2
2241,3241,9924,4423,2,0,2
2242,3242,9927,4466,3,1,2
2243,3243,9940,4477,1,0,1
2244,3244,9931,4427,3,2,1
2245,3245,9936,4462,5,2,3
2246,3246,9890,4422,3,3,0
2247,3247,9889,4502,2,2,0
2248,3248,9888,4504,1,0,1
2249,3249,9946,4470,1,0,1
2250,3250,9910,4482,2,1,1
2251,3251,9920,4419,4,3,1
2252,3252,9901,4466,6,2,4
2253,3253,9911,4484,2,1,1
2254,3254,9913,4482,1,0,1
2255,3255,9898,4442,2,0,2
2256,3256,9956,4448,1,0,1
2257,3257,9956,4449,3,0,3
2258,3258,9917,4424,23,6,17
2259,3259,9908,4463,4,2,2
2260,3260,9934,4460,5,2,3
2261,3261,9900,4474,1,0,1
2262,3262,9955,4436,1,0,1
2263,3263,9910,4454,1,0,1
2264,3264,9952,4468,1,0,1
2265,3265,9927,4421,4,0,4
2266,3266,9946,4427,1,1,0
2267,3267,9956,4427,1,0,1
2268,3268,9885,4419,2,1,1
2269,3269,9947,4461,1,0,1
2270,3270,9905,4434,10,7,3
2271,3271,9924,4474,2,0,2
2272,3272,9928,4469,3,0,3
2273,3273,9984,4468,5,2,3
2274,3274,9940,4454,4,2,2
2275,3275,9951,4462,2,0,2
2276,3276,9969,4469,1,1,0
2277,3277,9966,4469,1,0,1
2278,3278,9935,4423,1,0,1
2279,3279,9949,4491,1,0,1
2280,3280,9953,4435,3,0,3
2281,3281,9951,4457,5,3,2
2282,3282,9899,4449,7,2,5
2283,3283,9901,4432,3,1,2
2284,3284,9924,4473,2,0,2
2285,3285,9918,4466,8,3,5
2286,3286,9946,4487,1,1,0
2287,3287,9914,4474,1,0,1
2288,3288,9949,4448,2,2,0
2289,3289,9907,4424,5,5,0
2290,3290,9908,4425,6,2,4
2291,3291,9905,4423,1,0,1
2292,3292,9911,4472,4,4,0
2293,3293,9902,4420,2,1,1
2294,3294,9947,4467,9,3,6
2295,3295,9905,4463,3,2,1
2296,3296,9944,4460,1,1,0
2297,3297,9912,4421,3,1,2
2298,3298,9918,4412,5,3,2
2299,3299,9955,4438,1,0,1
2300,3300,9935,4458,3,0,3
2301,3301,9931,4461,3,0,3
2302,3302,9967,4430,1,0,1
2303,3303,9957,4435,2,2,0
2304,3304,9955,4425,1,1,0
2305,3305,9949,4426,1,0,1
2306,3306,9904,4434,6,2,4
2307,3307,9917,4468,3,1,2
2308,3308,9898,4454,2,0,2
2309,3309,9927,4426,6,2,4
2310,3310,9944,4449,5,0,5
2311,3311,9943,4467,5,3,2
2312,3312,9907,4479,2,1,1
2313,3313,9943,4469,4,2,2
2314,3314,9914,4414,1,0,1
2315,3315,9918,4417,8,6,2
2316,3316,9961,4493,1,1,0
2317,3317,9960,4492,2,1,1
2318,3318,9895,4419,3,0,3
2319,3319,9903,4468,1,0,1
2320,3320,9961,4460,2,0,2
2321,3321,9928,4463,2,2,0
2322,3322,9891,4453,1,1,0
2323,3323,9892,4453,1,0,1
2324,3324,9942,4462,1,1,0
2325,3325,9920,4402,2,1,1
2326,3326,9903,4433,3,0,3
2327,3327,9945,4424,2,2,0
2328,3328,9942,4423,2,1,1
2329,3329,9933,4472,1,0,1
2330,3330,9893,4439,1,1,0
2331,3331,9958,4427,2,0,2
2332,3332,9903,4458,3,2,1
2333,3333,9907,4471,2,1,1
2334,3334,9898,4423,2,0,2
2335,3335,9937,4430,3,1,2
2336,3336,9949,4410,2,0,2
2337,3337,9919,4414,1,1,0
2338,3338,9959,4425,1,0,1
2339,3339,9904,4467,1,0,1
2340,3340,9942,4417,3,2,1
2341,3341,9941,4428,1,0,1
2342,3342,9966,4464,1,0,1
2343,3343,9985,4468,3,2,1
2344,3344,9984,4469,1,0,1
2345,3345,9962,4446,4,1,3
2346,3346,9900,4478,2,0,2
2347,3347,9901,4478,4,1,3
2348,3348,9916,4471,5,2,3
2349,3349,9948,4454,2,2,0
2350,3350,9906,4465,1,0,1
2351,3351,9913,4415,5,1,4
2352,3352,9946,4461,1,0,1
2353,3353,9908,4474,2,1,1
2354,3354,9935,4411,1,0,1
2355,3355,9945,4473,3,2,1
2356,3356,9897,4449,1,0,1
2357,3357,9954,4484,1,1,0
2358,3358,9913,4428,5,0,5
2359,3359,9927,4469,5,0,5
2360,3360,9901,4425,2,0,2
2361,3361,9903,4415,2,1,1
2362,3362,9980,4468,1,1,0
2363,3363,9979,4468,1,0,1
2364,3364,9923,4466,5,1,4
2365,3365,9900,4436,1,0,1
2366,3366,9940,4429,2,0,2
2367,3367,9932,4460,7,0,7
2368,3368,9933,4423,3,1,2
2369,3369,9929,4422,6,0,6
2370,3370,9916,4415,2,1,1
2371,3371,9903,4482,1,0,1
2372,3372,9900,4419,4,2,2
2373,3373,9940,4433,3,0,3
2374,3374,9940,4421,4,3,1
2375,3375,9940,4468,1,0,1
2376,3376,9914,4468,9,4,5
2377,3377,9900,4464,3,1,2
2378,3378,9903,4465,11,5,6
2379,3379,9953,4445,3,0,3
2380,3380,9953,4432,1,0,1
2381,3381,9943,4449,1,0,1
2382,3382,9930,4464,2,0,2
2383,3383,9900,4435,2,0,2
2384,3384,9944,4430,2,1,1
2385,3385,9926,4422,8,2,6
2386,3386,9945,4437,4,2,2
2387,3387,9910,4467,2,0,2
2388,3388,9947,4466,7,2,5
2389,3389,9909,4422,3,3,0
2390,3390,9915,4421,3,0,3
2391,3391,9943,4433,2,0,2
2392,3392,9950,4423,1,0,1
2393,3393,9927,4468,8,1,7
2394,3394,9906,4477,1,0,1
2395,3395,9910,4478,2,1,1
2396,3396,9901,4457,1,1,0
2397,3397,9901,4461,4,3,1
2398,3398,9927,4473,1,0,1
2399,3399,9908,4415,4,2,2
2400,3400,9947,4451,1,0,1
2401,3401,9905,4429,2,1,1
2402,3402,9922,4468,1,1,0
2403,3403,9917,4475,2,0,2
2404,3404,9911,4427,12,9,3
2405,3405,9926,4420,2,0,2
2406,3406,9941,4455,2,0,2
2407,3407,9942,4425,4,2,2
2408,3408,9905,4455,2,1,1
2409,3409,9945,4454,2,0,2
2410,3410,9946,4454,1,1,0
2411,3411,9925,4422,3,1,2
2412,3412,9930,4424,3,0,3
2413,3413,9909,4432,2,1,1
2414,3414,9944,4414,3,0,3
2415,3415,9894,4424,2,0,2
2416,3416,9923,4471,3,0,3
2417,3417,9902,4469,3,0,3
2418,3418,9904,4463,1,1,0
2419,3419,9925,4415,1,1,0
2420,3420,9893,4408,3,0,3
2421,3421,9893,4449,1,0,1
2422,3422,9899,4464,11,4,7
2423,3423,9953,4428,1,1,0
2424,3424,9950,4429,3,1,2
2425,3425,9952,4448,2,0,2
2426,3426,9947,4434,1,0,1
2427,3427,9901,4460,2,2,0
2428,3428,9939,4476,1,0,1
2429,3429,9893,4419,1,0,1
2430,3430,9908,4480,1,0,1
2431,3431,9963,4493,7,4,3
2432,3432,9962,4493,3,1,2
2433,3433,9964,4495,2,0,2
2434,3434,9910,4469,1,0,1
2435,3435,9904,4471,1,0,1
2436,3436,9916,4478,1,0,1
2437,3437,9943,4452,4,0,4
2438,3438,9912,4487,2,2,0
2439,3439,9925,4418,7,5,2
2440,3440,9915,4473,1,0,1
2441,3441,9931,4472,1,0,1
2442,3442,9921,4416,2,1,1
2443,3443,9889,4418,4,2,2
2444,3444,9918,4396,1,0,1
2445,3445,9940,4439,1,0,1
2446,3446,9910,4479,1,0,1
2447,3447,9897,4427,2,2,0
2448,3448,9957,4436,1,1,0
2449,3449,9948,4436,3,1,2
2450,3450,9949,4435,1,0,1
2451,3451,9953,4441,3,1,2
2452,3452,9926,4417,6,1,5
2453,3453,9947,4443,2,0,2
2454,3454,9926,4471,2,0,2
2455,3455,9905,4425,2,0,2
2456,3456,9887,4423,1,0,1
2457,3457,9908,4438,4,1,3
2458,3458,9950,4437,8,2,6
2459,3459,9888,4419,1,1,0
2460,3460,9894,4488,1,1,0
2461,3461,9898,4429,2,0,2
2462,3462,9940,4485,1,1,0
2463,3463,9957,4446,4,0,4
2464,3464,9916,4468,3,0,3
2465,3465,9903,4473,2,0,2
2466,3466,9892,4492,1,1,0
2467,3467,9890,4492,1,0,1
2468,3468,9948,4471,7,3,4
2469,3469,9938,4468,2,1,1
2470,3470,9934,4471,4,2,2
2471,3471,9939,4455,2,0,2
2472,3472,9928,4476,1,0,1
2473,3473,9935,4417,2,2,0
2474,3474,9932,4418,7,6,1
2475,3475,9897,4419,1,0,1
2476,3476,9897,4420,1,1,0
2477,3477,9894,4425,1,0,1
2478,3478,9928,4466,2,0,2
2479,3479,9945,4489,1,0,1
2480,3480,9947,4413,4,2,2
2481,3481,9949,4452,1,1,0
2482,3482,9931,4419,1,0,1
2483,3483,9906,4418,1,1,0
2484,3484,9907,4426,5,2,3
2485,3485,9900,4457,1,1,0
2486,3486,9899,4456,1,0,1
2487,3487,9899,4426,2,2,0
2488,3488,9931,4459,4,3,1
2489,3489,9931,4460,3,1,2
2490,3490,9943,4421,2,1,1
2491,3491,9921,4467,3,0,3
2492,3492,9956,4433,2,1,1
2493,3493,9910,4516,1,0,1
2494,3494,9952,4439,2,1,1
2495,3495,9957,4431,2,1,1
2496,3496,9953,4427,1,0,1
2497,3497,9947,4449,2,0,2
2498,3498,9946,4447,3,2,1
2499,3499,9932,4464,3,3,0
2500,3500,9949,4482,1,0,1
2501,3501,9950,4483,1,1,0
2502,3502,9955,4486,2,1,1
2503,3503,9961,4490,3,1,2
2504,3504,9948,4455,3,1,2
2505,3505,9899,4462,2,1,1
2506,3506,9958,4415,1,0,1
2507,3507,9955,4467,1,1,0
2508,3508,9902,4479,3,2,1
2509,3509,9907,4438,2,0,2
2510,3510,9901,4428,1,1,0
2511,3511,9905,4420,2,1,1
2512,3512,9945,4487,2,0,2
2513,3513,9912,4473,1,0,1
2514,3514,9958,4445,1,1,0
2515,3515,9946,4425,1,1,0
2516,3516,9939,4414,1,1,0
2517,3517,9939,4418,1,0,1
2518,3518,9927,4409,2,2,0
2519,3519,9898,4421,6,3,3
2520,3520,9888,4425,2,0,2
2521,3521,9903,4439,2,0,2
2522,3522,9917,4396,1,0,1
2523,3523,9909,4472,3,1,2
2524,3524,9909,4421,1,0,1
2525,3525,9944,4448,4,0,4
2526,3526,9951,4469,1,0,1
2527,3527,9932,4473,3,1,2
2528,3528,9932,4474,1,1,0
2529,3529,9942,4485,1,0,1
2530,3530,9953,4482,1,0,1
2531,3531,9952,4463,1,0,1
2532,3532,9886,4422,3,1,2
2533,3533,9955,4454,1,0,1
2534,3534,9976,4458,1,0,1
2535,3535,9912,4470,7,0,7
2536,3536,9958,4420,1,0,1
2537,3537,9914,4421,4,0,4
2538,3538,9906,4422,1,0,1
2539,3539,9918,4470,2,0,2
2540,3540,9849,4500,1,0,1
2541,3541,9960,4493,1,0,1
2542,3542,9951,4435,1,1,0
2543,3543,9943,4476,1,0,1
2544,3544,9940,4424,2,0,2
2545,3545,9911,4465,2,0,2
2546,3546,9896,4471,1,0,1
2547,3547,9986,4466,1,1,0
2548,3548,9896,4451,2,0,2
2549,3549,9946,4449,1,1,0
2550,3550,9970,4476,1,0,1
2551,3551,9957,4402,1,0,1
2552,3552,9894,4444,1,0,1
2553,3553,9946,4450,4,0,4
2554,3554,9949,4462,1,0,1
2555,3555,9912,4426,2,2,0
2556,3556,9906,4473,2,2,0
2557,3557,9939,4417,1,0,1
2558,3558,9956,4436,3,1,2
2559,3559,9948,4491,1,0,1
2560,3560,9938,4433,3,1,2
2561,3561,9898,4413,1,1,0
2562,3562,9958,4491,1,0,1
2563,3563,9949,4456,5,2,3
2564,3564,9919,4419,4,3,1
2565,3565,9926,4418,1,0,1
2566,3566,9951,4442,2,0,2
2567,3567,9942,4464,2,0,2
2568,3568,9954,4461,5,3,2
2569,3569,9931,4417,1,0,1
2570,3570,9906,4478,1,0,1
2571,3571,9926,4476,1,0,1
2572,3572,9899,4413,3,1,2
2573,3573,9897,4414,4,2,2
2574,3574,9961,4468,1,0,1
2575,3575,9991,4471,1,0,1
2576,3576,9954,4448,1,0,1
2577,3577,9919,4467,1,0,1
2578,3578,9975,4429,1,0,1
2579,3579,9909,4481,1,0,1
2580,3580,9956,4408,1,0,1
2581,3581,9911,4467,1,0,1
2582,3582,9945,4455,1,1,0
2583,3583,9907,4463,1,1,0
2584,3584,9929,4458,1,0,1
2585,3585,9903,4472,1,0,1
2586,3586,9928,4468,1,0,1
2587,3587,9955,4441,3,1,2
2588,3588,9896,4418,3,1,2
2589,3589,9942,4429,1,0,1
2590,3590,9901,4467,2,0,2
2591,3591,9898,4427,2,1,1
2592,3592,9941,4486,4,2,2
2593,3593,9925,4413,1,1,0
2594,3594,9942,4413,1,1,0
2595,3595,9882,4407,2,1,1
2596,3596,9889,4411,2,1,1
2597,3597,9951,4441,4,2,2
2598,3598,9905,4466,1,0,1
2599,3599,9900,4406,1,1,0
2600,3600,9948,4469,1,0,1
2601,3601,9903,4457,3,1,2
2602,3602,9907,4472,1,0,1
2603,3603,9960,4494,1,1,0
2604,3604,9962,4494,2,1,1
2605,3605,9939,4468,2,0,2
2606,3606,9901,4465,2,0,2
2607,3607,9948,4464,1,0,1
2608,3608,9947,4463,5,2,3
2609,3609,9930,4475,1,0,1
2610,3610,9932,4468,2,1,1
2611,3611,9889,4417,1,1,0
2612,3612,9889,4415,2,1,1
2613,3613,9938,4415,1,1,0
2614,3614,9908,4467,4,1,3
2615,3615,9943,4425,1,0,1
2616,3616,9948,4496,2,1,1
2617,3617,9942,4471,1,0,1
2618,3618,9910,4480,2,0,2
2619,3619,9914,4476,1,1,0
2620,3620,9944,4413,1,1,0
2621,3621,9940,4416,1,0,1
2622,3622,9949,4451,3,0,3
2623,3623,9928,4422,2,0,2
2624,3624,9918,4469,2,0,2
2625,3625,9917,4469,2,1,1
2626,3626,9951,4434,1,0,1
2627,3627,9947,4418,1,0,1
2628,3628,9887,4495,1,1,0
2629,3629,9952,4429,1,0,1
2630,3630,9919,4418,4,2,2
2631,3631,9947,4425,1,0,1
2632,3632,9947,4462,4,1,3
2633,3633,9961,4446,2,0,2
2634,3634,9956,4412,1,0,1
2635,3635,9942,4486,2,0,2
2636,3636,9910,4472,2,0,2
2637,3637,9943,4434,2,1,1
2638,3638,9905,4468,2,2,0
2639,3639,9933,4466,1,1,0
2640,3640,9944,4466,1,1,0
2641,3641,9903,4479,2,0,2
2642,3642,9944,4431,1,0,1
2643,3643,9921,4479,1,0,1
2644,3644,9903,4420,3,1,2
2645,3645,9933,4469,1,1,0
2646,3646,9940,4420,1,1,0
2647,3647,9935,4419,1,0,1
2648,3648,9943,4420,1,0,1
2649,3649,9891,4422,1,0,1
2650,3650,9946,4478,1,1,0
2651,3651,9943,4473,1,0,1
2652,3652,9987,4470,1,0,1
2653,3653,9959,4458,1,0,1
2654,3654,9920,4474,1,0,1
2655,3655,9923,4474,1,0,1
2656,3656,9900,4466,1,1,0
2657,3657,9925,4406,1,0,1
2658,3658,9951,4468,1,0,1
2659,3659,9925,4475,1,0,1
2660,3660,9941,4474,1,0,1
2661,3661,9965,4421,1,0,1
2662,3662,9947,4446,1,0,1
2663,3663,9931,4418,2,0,2
2664,3664,9944,4477,1,0,1
2665,3665,9936,4423,6,2,4
2666,3666,9953,4468,4,1,3
2667,3667,9953,4444,2,1,1
2668,3668,9920,4477,2,1,1
2669,3669,9900,4481,1,0,1
2670,3670,9889,4493,1,1,0
2671,3671,9886,4494,1,0,1
2672,3672,9954,4469,1,0,1
2673,3673,9911,4412,1,0,1
2674,3674,9923,4422,2,1,1
2675,3675,9902,4437,1,0,1
2676,3676,9942,4460,1,1,0
2677,3677,9919,4478,1,0,1
2678,3678,9908,4410,1,1,0
2679,3679,9908,4413,1,0,1
2680,3680,9910,4428,7,1,6
2681,3681,9948,4434,2,0,2
2682,3682,9922,4472,1,1,0
2683,3683,9898,4451,5,2,3
2684,3684,9897,4450,2,0,2
2685,3685,9923,4467,1,1,0
2686,3686,9923,4470,3,1,2
2687,3687,9893,4438,2,0,2
2688,3688,9973,4498,3,1,2
2689,3689,9921,4471,2,2,0
2690,3690,9936,4466,3,0,3
2691,3691,9899,4475,1,0,1
2692,3692,9919,4471,1,1,0
2693,3693,9899,4472,1,0,1
2694,3694,9942,4435,1,1,0
2695,3695,9942,4416,1,1,0
2696,3696,9943,4413,1,0,1
2697,3697,9901,4427,1,0,1
2698,3698,9897,4431,1,0,1
2699,3699,9953,4465,1,1,0
2700,3700,9907,4450,5,1,4
2701,3701,9911,4483,1,1,0
2702,3702,9916,4414,1,0,1
2703,3703,9908,4427,2,0,2
2704,3704,9894,4420,1,0,1
2705,3705,9945,4447,1,0,1
2706,3706,9948,4462,1,0,1
2707,3707,9899,4459,2,0,2
2708,3708,9900,4459,2,0,2
2709,3709,9891,4419,1,0,1
2710,3710,9945,4432,1,1,0
2711,3711,9950,4441,1,0,1
2712,3712,9935,4478,1,0,1
2713,3713,9941,4481,1,1,0
2714,3714,9948,4483,1,0,1
2715,3715,9899,4420,1,0,1
2716,3716,9932,4465,2,1,1
2717,3717,9951,4488,1,0,1
2718,3718,9933,4468,2,2,0
2719,3719,9964,4431,1,1,0
2720,3720,9941,4448,2,0,2
2721,3721,9945,4414,1,0,1
2722,3722,9945,4430,1,0,1
2723,3723,9946,4435,2,0,2
2724,3724,9943,4448,1,0,1
2725,3725,9965,4431,1,0,1
2726,3726,9904,4415,1,0,1
2727,3727,9920,4469,1,0,1
2728,3728,9896,4475,1,0,1
2729,3729,9913,4472,1,0,1
2730,3730,9921,4422,2,0,2
2731,3731,9907,4461,1,0,1
2732,3732,9900,4418,1,0,1
2733,3733,9900,4433,1,0,1
2734,3734,9913,4465,1,0,1
2735,3735,9950,4431,1,0,1
2736,3736,9893,4420,1,1,0
2737,3737,9923,4468,3,2,1
2738,3738,9941,4424,2,0,2
2739,3739,9951,4464,1,0,1
2740,3740,9902,4459,1,0,1
2741,3741,9960,4448,1,0,1
2742,3742,9918,4473,1,0,1
2743,3743,9937,4476,1,0,1
2744,3744,9931,4474,1,0,1
2745,3745,9900,4434,2,0,2
2746,3746,9905,4422,12,3,9
2747,3747,9942,4469,1,1,0
2748,3748,9947,4492,2,0,2
2749,3749,9909,4479,2,1,1
2750,3750,9906,4455,1,0,1
2751,3751,9928,4409,1,0,1
2752,3752,9923,4416,1,0,1
2753,3753,9902,4461,1,1,0
2754,3754,9887,4410,2,2,0
2755,3755,9887,4411,1,0,1
2756,3756,9915,4470,1,0,1
2757,3757,9903,4427,1,1,0
2758,3758,9931,4468,1,0,1
2759,3759,9963,4494,2,1,1
2760,3760,9964,4493,1,0,1
2761,3761,9941,4430,2,1,1
2762,3762,9947,4430,1,0,1
2763,3763,9946,4456,1,1,0
2764,3764,9901,4434,2,0,2
2765,3765,9904,4436,2,0,2
2766,3766,9881,4404,1,0,1
2767,3767,9889,4414,1,1,0
2768,3768,9910,4434,5,1,4
2769,3769,9944,4458,1,0,1
2770,3770,9918,4398,1,0,1
2771,3771,9954,4478,1,0,1
2772,3772,9940,4425,5,0,5
2773,3773,9922,4416,1,0,1
2774,3774,9895,4450,1,0,1
2775,3775,9952,4449,1,0,1
2776,3776,9900,4429,1,0,1
2777,3777,9934,4473,1,0,1
2778,3778,9898,4448,1,0,1
2779,3779,9894,4421,1,1,0
2780,3780,9893,4421,1,0,1
2781,3781,9947,4433,2,0,2
2782,3782,9919,4416,2,0,2
2783,3783,9898,4430,1,0,1
2784,3784,9912,4454,1,0,1
2785,3785,9957,4443,1,0,1
2786,3786,9866,4405,1,0,1
2787,3787,9952,4471,1,1,0
2788,3788,9960,4428,1,1,0
2789,3789,9940,4481,1,0,1
2790,3790,9947,4497,2,0,2
2791,3791,9963,4447,1,0,1
2792,3792,9893,4425,1,0,1
2793,3793,9893,4409,1,1,0
2794,3794,9894,4426,2,1,1
2795,3795,9914,4475,1,1,0
2796,3796,9933,4480,1,1,0
2797,3797,9938,4440,2,0,2
2798,3798,9918,4475,2,0,2
2799,3799,9901,4463,2,0,2
2800,3800,9905,4408,1,0,1
2801,3801,9902,4417,1,0,1
2802,3802,9917,4466,1,1,0
2803,3803,9918,4467,1,0,1
2804,3804,9887,4493,1,0,1
2805,3805,9942,4454,1,1,0
2806,3806,9964,4402,1,0,1
2807,3807,9909,4488,1,0,1
2808,3808,9900,4417,1,0,1
2809,3809,9940,4427,1,0,1
2810,3810,9985,4464,1,0,1
2811,3811,9950,4474,2,1,1
2812,3812,9941,4484,1,0,1
2813,3813,9950,4472,1,1,0
2814,3814,9920,4418,4,1,3
2815,3815,9945,4474,2,1,1
2816,3816,9903,4434,1,0,1
2817,3817,9924,4417,1,0,1
2818,3818,9937,4480,1,1,0
2819,3819,9898,4441,2,0,2
2820,3820,9940,4418,2,2,0
2821,3821,9946,4480,1,1,0
2822,3822,9933,4460,1,0,1
2823,3823,9900,4477,1,1,0
2824,3824,9935,4469,1,1,0
2825,3825,9882,4406,1,1,0
2826,3826,9875,4403,1,0,1
2827,3827,9906,4475,1,0,1
2828,3828,9932,4480,2,0,2
2829,3829,9943,4464,1,0,1
2830,3830,9953,4447,1,0,1
2831,3831,9917,4423,1,1,0
2832,3832,9953,4438,1,1,0
2833,3833,9909,4468,1,0,1
2834,3834,9900,4467,1,0,1
2835,3835,9931,4470,1,0,1
2836,3836,9954,4489,1,1,0
2837,3837,9934,4470,1,0,1
2838,3838,9929,4473,1,1,0
2839,3839,9961,4492,1,0,1
2840,3840,9974,4499,1,1,0
2841,3841,9898,4438,2,0,2
2842,3842,9941,4467,1,0,1
2843,3843,9957,4449,3,0,3
2844,3844,9949,4409,1,0,1
2845,3845,9933,4475,1,0,1
2846,3846,9956,4438,1,0,1
2847,3847,9935,4421,1,0,1
2848,3848,9904,4423,1,0,1
2849,3849,9945,4427,1,0,1
2850,3850,9904,4462,2,2,0
2851,3851,9963,4430,1,0,1
2852,3852,9951,4436,1,0,1
2853,3853,9887,4424,1,1,0
2854,3854,9880,4404,1,1,0
2855,3855,9874,4406,1,0,1
2856,3856,9898,4425,1,0,1
2857,3857,9900,4424,2,0,2
2858,3858,9935,4416,2,0,2
2859,3859,9953,4439,1,0,1
2860,3860,9951,4463,1,0,1
2861,3861,9909,4480,1,1,0
2862,3862,9960,4449,2,0,2
2863,3863,9959,4448,1,1,0
2864,3864,9960,4447,2,0,2
2865,3865,9950,4462,1,0,1
2866,3866,9951,4402,1,0,1
2867,3867,9956,4468,1,0,1
2868,3868,9908,4476,3,0,3
2869,3869,9904,4435,2,0,2
2870,3870,9933,4465,1,0,1
2871,3871,9942,4481,1,0,1
2872,3872,9903,4417,2,1,1
2873,3873,9893,4427,2,0,2
2874,3874,9899,4429,1,1,0
2875,3875,9895,4429,1,1,0
2876,3876,9952,4444,1,0,1
2877,3877,9919,4468,1,0,1
2878,3878,9951,4461,1,1,0
2879,3879,9932,4458,1,0,1
2880,3880,9896,4426,2,1,1
2881,3881,9890,4504,1,0,1
2882,3882,9941,4485,1,1,0
2883,3883,9945,4433,1,1,0
2884,3884,9985,4467,2,1,1
2885,3885,9899,4419,1,1,0
2886,3886,9943,4422,1,0,1
2887,3887,9943,4474,1,1,0
2888,3888,9942,4466,1,0,1
2889,3889,9965,4430,1,1,0
2890,3890,9966,4429,1,0,1
2891,3891,9951,4467,2,1,1
2892,3892,9959,4469,1,0,1
2893,3893,9943,4447,2,0,2
2894,3894,9905,4454,1,0,1
2895,3895,9943,4432,1,0,1
2896,3896,9949,4453,1,0,1
2897,3897,9948,4452,2,2,0
2898,3898,9941,4493,1,0,1
2899,3899,9896,4432,1,0,1
2900,3900,9867,4402,1,1,0
2901,3901,9866,4404,1,0,1
2902,3902,9902,4478,2,0,2
2903,3903,9905,4449,1,0,1
2904,3904,9961,4408,1,0,1
2905,3905,9938,4474,1,1,0
2906,3906,9952,4416,1,0,1
2907,3907,9894,4450,1,1,0
2908,3908,9908,4429,1,0,1
2909,3909,9940,4469,2,0,2
2910,3910,9958,4428,1,1,0
2911,3911,9913,4486,1,1,0
2912,3912,9888,4412,1,0,1
2913,3913,9941,4426,1,0,1
2914,3914,9895,4411,1,1,0
2915,3915,9895,4410,1,0,1
2916,3916,9900,4465,1,0,1
2917,3917,9901,4454,1,0,1
2918,3918,9926,4411,1,1,0
2919,3919,9947,4468,1,0,1
2920,3920,9944,4461,1,0,1
2921,3921,9944,4459,1,1,0
2922,3922,9930,4477,1,0,1
2923,3923,9946,4430,2,0,2
2924,3924,9946,4464,1,0,1
2925,3925,9949,4465,2,2,0
2926,3926,9951,4447,2,0,2
2927,3927,9929,4463,2,0,2
2928,3928,9900,4452,1,0,1
2929,3929,9961,4489,1,0,1
2930,3930,9960,4466,1,1,0
2931,3931,9911,4423,1,0,1
2932,3932,9896,4433,1,0,1
2933,3933,9894,4428,1,1,0
2934,3934,9924,4479,1,0,1
2935,3935,9933,4422,1,0,1
2936,3936,9911,4469,1,1,0
2937,3937,9901,4475,1,0,1
2938,3938,9985,4469,1,0,1
2939,3939,9914,4424,5,3,2
2940,3940,9959,4424,1,0,1
2941,3941,9900,4426,1,0,1
2942,3942,9951,4448,1,0,1
2943,3943,9945,4431,1,0,1
2944,3944,9943,4435,1,0,1
2945,3945,9917,4393,1,0,1
2946,3946,9918,4405,1,1,0
2947,3947,9934,4422,2,1,1
2948,3948,9942,4476,1,0,1
2949,3949,9922,4480,1,1,0
2950,3950,9900,4423,1,0,1
2951,3951,9962,4469,1,1,0
2952,3952,9963,4470,1,0,1
2953,3953,9939,4415,1,1,0
2954,3954,9936,4467,1,0,1
2955,3955,9943,4490,1,1,0
2956,3956,9938,4500,1,0,1
2957,3957,9933,4464,2,0,2
2958,3958,9916,4392,1,0,1
2959,3959,9946,4432,1,1,0
2960,3960,9899,4432,1,0,1
2961,3961,9906,4423,1,0,1
2962,3962,9917,4418,1,1,0
2963,3963,9929,4411,1,0,1
2964,3964,9941,4464,1,0,1
2965,3965,9929,4468,1,0,1
2966,3966,9927,4407,1,0,1
2967,3967,9960,4471,1,0,1
2968,3968,9943,4472,2,1,1
2969,3969,9899,4443,1,0,1
2970,3970,9893,4440,1,0,1
2971,3971,9953,4463,1,1,0
2972,3972,9920,4479,1,0,1
2973,3973,9918,4420,1,0,1
2974,3974,9935,4422,1,0,1
2975,3975,9872,4402,1,0,1
2976,3976,9939,4470,1,0,1
2977,3977,9934,4472,3,2,1
2978,3978,9979,4470,1,1,0
2979,3979,9980,4470,1,0,1
2980,3980,9909,4464,1,0,1
2981,3981,9899,4463,1,0,1
2982,3982,9904,4481,1,0,1
2983,3983,9955,4490,1,1,0
2984,3984,9952,4441,1,0,1
2985,3985,9958,4425,1,1,0
2986,3986,9962,4422,1,0,1
2987,3987,9939,4432,1,0,1
2988,3988,9946,4434,1,0,1
2989,3989,9894,4439,1,0,1
2990,3990,9940,4434,1,0,1
2991,3991,9935,4415,2,0,2
2992,3992,9908,4412,1,1,0
2993,3993,9944,4472,1,0,1
2994,3994,9909,4467,1,0,1
2995,3995,9945,4461,1,0,1
2996,3996,9903,4456,1,0,1
2997,3997,9926,4413,1,1,0
2998,3998,9892,4426,1,1,0
2999,3999,9962,4496,1,0,1
3000,4000,9927,4417,1,1,0
3001,4001,9946,4420,1,0,1
3002,4002,9919,4410,1,1,0
3003,4003,9904,4469,1,0,1
3004,4004,9968,4420,1,0,1
3005,4005,9915,4410,1,0,1
3006,4006,9903,4477,1,1,0
3007,4007,9896,4415,1,1,0
3008,4008,9904,4446,1,1,0
3009,4009,9949,4494,1,1,0
3010,4010,9948,4494,2,1,1
3011,4011,9948,4495,2,1,1
3012,4012,9947,4495,1,0,1
3013,4013,9953,4442,1,0,1
3014,4014,9947,4477,1,0,1
3015,4015,9945,4486,2,0,2
3016,4016,9965,4447,1,0,1
3017,4017,9927,4477,1,0,1
3018,4018,9913,4422,1,0,1
3019,4019,9959,4485,1,1,0
3020,4020,9966,4495,1,0,1
3021,4021,9945,4445,1,0,1
3022,4022,9936,4470,1,1,0
3023,4023,9896,4438,1,0,1
3024,4024,9905,4415,1,1,0
3025,4025,9951,4471,1,0,1
