id,unicode,X,Y,population,travellers,visitors
1,1001,76,63,72,36,36
2,1002,76,62,124,62,62
3,1003,78,101,392,194,198
4,1004,84,83,435,217,218
5,1005,84,80,1101,551,550
6,1006,86,80,555,277,278
7,1007,71,113,167,84,83
8,1008,64,134,56,28,28
9,1009,52,134,352,175,177
10,1010,49,126,171,86,85
11,1011,84,82,1299,649,650
12,1012,83,82,450,226,224
13,1013,80,101,188,94,94
14,1014,84,88,124,61,63
15,1015,84,84,340,171,169
16,1016,76,88,153,74,79
17,1017,47,133,92,48,44
18,1018,59,77,325,164,161
19,1019,42,101,234,118,116
20,1020,39,107,177,89,88
21,1021,52,126,134,67,67
22,1022,59,124,152,76,76
23,1023,73,95,52,27,25
24,1024,72,95,350,175,175
25,1025,48,111,157,79,78
26,1026,47,115,211,107,104
27,1027,49,136,185,93,92
28,1028,48,139,80,38,42
29,1029,70,93,223,113,110
30,1030,73,90,214,108,106
31,1031,81,96,111,55,56
32,1032,56,138,224,111,113
33,1033,49,139,57,29,28
34,1034,81,83,108,54,54
35,1035,78,86,210,106,104
36,1036,73,92,195,96,99
37,1037,70,76,112,56,56
38,1038,69,75,172,86,86
39,1039,82,89,163,82,81
40,1040,83,86,478,242,236
41,1041,33,116,65,33,32
42,1042,26,116,209,104,105
43,1043,72,83,229,116,113
44,1044,71,80,255,128,127
45,1045,43,114,202,101,101
46,1046,35,114,126,63,63
47,1047,70,67,96,48,48
48,1048,73,68,182,90,92
49,1049,32,105,78,39,39
50,1050,31,107,73,36,37
51,1051,66,128,141,70,71
52,1052,68,132,34,17,17
53,1053,80,37,118,57,61
54,1054,83,37,28,14,14
55,1055,83,84,154,77,77
56,1056,88,67,168,85,83
57,1057,83,87,307,154,153
58,1058,47,117,242,119,123
59,1059,92,53,44,22,22
60,1060,92,49,35,17,18
61,1061,62,96,272,136,136
62,1062,59,97,185,93,92
63,1063,71,94,121,61,60
64,1064,74,101,453,227,226
65,1065,81,73,62,31,31
66,1066,87,66,205,102,103
67,1067,18,59,141,71,70
68,1068,14,49,92,48,44
69,1069,74,48,111,55,56
70,1070,76,50,116,57,59
71,1071,46,76,169,84,85
72,1072,44,77,46,24,22
73,1073,83,85,278,139,139
74,1074,80,90,139,71,68
75,1075,75,53,44,21,23
76,1076,73,46,132,65,67
77,1077,84,59,65,33,32
78,1078,85,54,63,32,31
79,1079,24,72,81,40,41
80,1080,82,67,8,4,4
81,1081,49,96,71,36,35
82,1082,59,92,72,35,37
83,1083,64,99,244,121,123
84,1084,64,101,211,106,105
85,1085,67,108,52,26,26
86,1086,69,136,119,59,60
87,1087,73,49,177,89,88
88,1088,70,49,174,88,86
89,1089,52,77,77,37,40
90,1090,55,125,118,57,61
91,1091,40,95,59,30,29
92,1092,35,95,164,82,82
93,1093,77,92,20,10,10
94,1094,82,79,133,67,66
95,1095,67,106,187,92,95
96,1096,69,109,444,221,223
97,1097,59,74,246,122,124
98,1098,74,66,98,49,49
99,1099,83,67,46,23,23
100,1100,53,97,232,116,116
101,1101,54,97,185,93,92
102,1102,52,108,178,89,89
103,1103,49,107,200,100,100
104,1104,42,133,98,48,50
105,1105,59,129,108,54,54
106,1106,64,137,76,38,38
107,1107,43,123,104,54,50
108,1108,42,127,128,65,63
109,1109,59,82,138,71,67
110,1110,80,59,80,40,40
111,1111,78,59,58,29,29
112,1112,54,43,86,42,44
113,1113,59,43,46,23,23
114,1114,79,87,54,28,26
115,1115,78,88,159,79,80
116,1116,67,114,94,47,47
117,1117,64,114,168,83,85
118,1118,63,72,78,39,39
119,1119,63,74,255,126,129
120,1120,86,83,758,379,379
121,1121,85,83,650,325,325
122,1122,80,82,66,33,33
123,1123,75,74,64,32,32
124,1124,45,98,52,25,27
125,1125,44,96,239,121,118
126,1126,77,89,219,110,109
127,1127,75,89,51,25,26
128,1128,79,57,32,16,16
129,1129,48,37,45,23,22
130,1130,88,72,710,354,356
131,1131,88,68,269,137,132
132,1132,32,135,151,75,76
133,1133,30,135,52,26,26
134,1134,88,73,324,162,162
135,1135,77,60,88,44,44
136,1136,32,98,38,19,19
137,1137,48,79,100,50,50
138,1138,58,119,351,180,171
139,1139,73,96,200,100,100
140,1140,76,99,89,44,45
141,1141,65,74,289,145,144
142,1142,82,73,40,20,20
143,1143,83,70,36,18,18
144,1144,57,113,150,75,75
145,1145,71,47,169,85,84
146,1146,25,101,188,93,95
147,1147,30,98,209,104,105
148,1148,26,89,107,53,54
149,1149,28,84,71,35,36
150,1150,80,77,37,18,19
151,1151,81,74,57,28,29
152,1152,79,97,300,150,150
153,1153,55,135,321,159,162
154,1154,64,135,104,51,53
155,1155,86,75,120,60,60
156,1156,80,89,197,99,98
157,1157,82,83,163,81,82
158,1158,49,101,623,311,312
159,1159,89,63,108,51,57
160,1160,30,117,490,248,242
161,1161,32,126,120,60,60
162,1162,75,70,130,64,66
163,1163,85,85,156,78,78
164,1164,81,99,548,273,275
165,1165,78,98,147,74,73
166,1166,49,67,84,42,42
167,1167,67,79,201,99,102
168,1168,35,65,247,125,122
169,1169,54,79,58,29,29
170,1170,52,82,110,55,55
171,1171,81,101,226,114,112
172,1172,77,106,224,112,112
173,1173,70,83,445,222,223
174,1174,69,82,265,132,133
175,1175,68,86,86,43,43
176,1176,74,70,9,5,4
177,1177,53,92,109,55,54
178,1178,60,78,100,50,50
179,1179,52,69,44,22,22
180,1180,52,67,87,44,43
181,1181,66,101,81,42,39
182,1182,69,102,119,58,61
183,1183,45,114,128,62,66
184,1184,49,115,48,24,24
185,1185,53,107,170,84,86
186,1186,78,62,119,60,59
187,1187,87,30,104,52,52
188,1188,84,36,36,18,18
189,1189,57,122,215,109,106
190,1190,82,69,51,26,25
191,1191,83,72,58,29,29
192,1192,72,57,157,79,78
193,1193,74,56,179,89,90
194,1194,65,90,98,49,49
195,1195,59,87,72,36,36
196,1196,84,86,259,128,131
197,1197,71,115,151,76,75
198,1198,62,127,150,75,75
199,1199,60,135,160,79,81
200,1200,59,134,131,65,66
201,1201,79,86,117,58,59
202,1202,79,84,47,24,23
203,1203,65,89,58,29,29
204,1204,70,89,150,75,75
205,1205,73,38,4,2,2
206,1206,43,68,85,42,43
207,1207,40,66,130,64,66
208,1208,36,68,324,162,162
209,1209,71,99,130,64,66
210,1210,74,30,70,36,34
211,1211,66,38,144,73,71
212,1212,86,65,12,6,6
213,1213,88,65,42,21,21
214,1214,45,139,84,42,42
215,1215,47,101,206,103,103
216,1216,45,101,136,67,69
217,1217,47,43,26,11,15
218,1218,77,80,59,29,30
219,1219,67,73,50,25,25
220,1220,75,97,78,39,39
221,1221,74,96,165,82,83
222,1222,77,94,154,77,77
223,1223,78,95,181,90,91
224,1224,83,57,83,42,41
225,1225,83,58,48,24,24
226,1226,83,80,802,397,405
227,1227,51,138,63,31,32
228,1228,56,101,106,53,53
229,1229,53,101,162,81,81
230,1230,62,98,98,49,49
231,1231,74,62,48,24,24
232,1232,73,57,78,38,40
233,1233,63,77,90,46,44
234,1234,72,76,72,36,36
235,1235,67,132,26,13,13
236,1236,83,43,122,61,61
237,1237,82,46,208,104,104
238,1238,26,80,344,172,172
239,1239,38,72,217,108,109
240,1240,55,112,148,74,74
241,1241,57,123,93,48,45
242,1242,76,64,266,133,133
243,1243,65,47,323,161,162
244,1244,26,58,263,131,132
245,1245,65,143,80,41,39
246,1246,82,86,254,130,124
247,1247,78,87,131,67,64
248,1248,59,109,142,70,72
249,1249,61,99,93,46,47
250,1250,65,98,116,58,58
251,1251,81,98,198,99,99
252,1252,83,83,189,95,94
253,1253,54,103,235,117,118
254,1254,51,106,264,132,132
255,1255,83,79,261,130,131
256,1256,83,76,43,22,21
257,1257,69,48,180,89,91
258,1258,48,88,85,42,43
259,1259,65,73,163,80,83
260,1260,64,73,259,128,131
261,1261,87,73,67,34,33
262,1262,84,66,88,45,43
263,1263,82,88,158,80,78
264,1264,83,88,332,168,164
265,1265,83,94,182,91,91
266,1266,81,94,30,15,15
267,1267,62,80,52,26,26
268,1268,83,62,28,14,14
269,1269,82,66,33,17,16
270,1270,74,99,113,56,57
271,1271,78,102,204,102,102
272,1272,57,103,135,67,68
273,1273,15,26,190,94,96
274,1274,26,28,115,58,57
275,1275,59,69,100,50,50
276,1276,85,77,80,40,40
277,1277,48,113,78,39,39
278,1278,65,111,212,107,105
279,1279,79,83,51,26,25
280,1280,54,77,299,142,157
281,1281,49,85,58,30,28
282,1282,73,88,168,84,84
283,1283,73,82,173,87,86
284,1284,80,102,377,188,189
285,1285,62,134,143,72,71
286,1286,85,82,880,436,444
287,1287,25,96,233,118,115
288,1288,49,134,222,110,112
289,1289,66,137,41,20,21
290,1290,66,139,91,45,46
291,1291,77,101,146,75,71
292,1292,20,136,67,34,33
293,1293,31,101,145,72,73
294,1294,25,75,124,62,62
295,1295,26,73,106,52,54
296,1296,80,86,74,37,37
297,1297,82,84,59,29,30
298,1298,89,48,47,23,24
299,1299,89,43,69,34,35
300,1300,74,63,99,49,50
301,1301,78,63,46,22,24
302,1302,70,117,93,47,46
303,1303,73,113,154,77,77
304,1304,54,109,164,82,82
305,1305,56,72,98,51,47
306,1306,54,70,149,74,75
307,1307,81,80,422,213,209
308,1308,56,121,42,21,21
309,1309,62,115,84,42,42
310,1310,50,132,147,73,74
311,1311,81,79,115,58,57
312,1312,68,123,64,32,32
313,1313,82,95,243,123,120
314,1314,84,87,240,118,122
315,1315,83,64,94,48,46
316,1316,83,66,94,46,48
317,1317,69,97,154,77,77
318,1318,45,148,87,44,43
319,1319,49,146,83,42,41
320,1320,56,68,80,40,40
321,1321,81,85,95,46,49
322,1322,81,84,138,70,68
323,1323,53,75,201,101,100
324,1324,89,68,176,88,88
325,1325,66,78,104,53,51
326,1326,64,78,57,28,29
327,1327,60,65,174,88,86
328,1328,58,68,169,86,83
329,1329,80,60,103,52,51
330,1330,69,113,219,110,109
331,1331,59,111,133,66,67
332,1332,55,111,238,119,119
333,1333,88,63,48,23,25
334,1334,91,65,29,15,14
335,1335,43,107,181,90,91
336,1336,45,106,62,31,31
337,1337,79,90,90,45,45
338,1338,20,102,156,80,76
339,1339,25,114,156,77,79
340,1340,50,96,64,32,32
341,1341,47,95,87,43,44
342,1342,66,75,106,53,53
343,1343,78,97,142,71,71
344,1344,78,68,68,34,34
345,1345,27,104,178,89,89
346,1346,30,95,82,41,41
347,1347,83,69,11,5,6
348,1348,87,76,49,24,25
349,1349,81,88,90,45,45
350,1350,80,88,112,56,56
351,1351,81,62,98,49,49
352,1352,73,109,222,111,111
353,1353,78,66,109,54,55
354,1354,79,67,55,27,28
355,1355,26,67,86,43,43
356,1356,24,69,113,57,56
357,1357,69,77,196,97,99
358,1358,75,64,139,71,68
359,1359,24,67,65,33,32
360,1360,18,68,258,129,129
361,1361,73,60,72,36,36
362,1362,20,126,190,94,96
363,1363,22,118,130,65,65
364,1364,78,99,239,120,119
365,1365,27,84,88,45,43
366,1366,40,72,133,65,68
367,1367,40,68,312,153,159
368,1368,43,47,150,75,75
369,1369,36,47,312,158,154
370,1370,53,111,68,34,34
371,1371,73,69,40,23,17
372,1372,71,77,79,40,39
373,1373,69,43,182,92,90
374,1374,17,128,181,90,91
375,1375,59,52,58,29,29
376,1376,56,92,173,88,85
377,1377,84,63,50,25,25
378,1378,85,74,36,18,18
379,1379,71,83,273,138,135
380,1380,54,101,60,30,30
381,1381,68,57,140,70,70
382,1382,74,90,198,99,99
383,1383,65,109,98,49,49
384,1384,61,111,91,45,46
385,1385,88,52,121,59,62
386,1386,88,53,63,32,31
387,1387,26,113,224,113,111
388,1388,76,66,110,54,56
389,1389,76,95,89,44,45
390,1390,78,90,138,70,68
391,1391,65,75,131,66,65
392,1392,28,70,116,57,59
393,1393,30,76,234,118,116
394,1394,80,83,94,48,46
395,1395,57,77,211,104,107
396,1396,56,83,73,36,37
397,1397,59,116,80,40,40
398,1398,40,127,44,22,22
399,1399,81,89,230,117,113
400,1400,64,84,79,40,39
401,1401,73,77,95,47,48
402,1402,73,79,74,37,37
403,1403,51,82,58,29,29
404,1404,49,82,133,68,65
405,1405,82,90,71,35,36
406,1406,86,62,111,55,56
407,1407,131,35,2,1,1
408,1408,66,95,108,54,54
409,1409,59,83,265,134,131
410,1410,67,49,75,37,38
411,1411,69,52,157,78,79
412,1412,65,115,107,53,54
413,1413,68,113,175,89,86
414,1414,71,107,217,109,108
415,1415,69,89,112,56,56
416,1416,68,84,127,62,65
417,1417,45,82,121,60,61
418,1418,54,82,115,57,58
419,1419,43,65,59,29,30
420,1420,79,103,282,141,141
421,1421,69,50,131,69,62
422,1422,80,94,73,36,37
423,1423,82,93,240,120,120
424,1424,83,77,80,40,40
425,1425,84,78,86,43,43
426,1426,78,79,109,55,54
427,1427,78,72,37,19,18
428,1428,83,89,210,105,105
429,1429,78,78,64,32,32
430,1430,53,86,37,19,18
431,1431,78,53,87,43,44
432,1432,72,54,95,48,47
433,1433,68,99,203,100,103
434,1434,66,103,131,65,66
435,1435,30,115,91,45,46
436,1436,87,47,127,64,63
437,1437,83,46,119,61,58
438,1438,61,73,37,18,19
439,1439,59,138,16,8,8
440,1440,41,144,61,30,31
441,1441,39,144,46,21,25
442,1442,45,55,95,49,46
443,1443,43,90,54,27,27
444,1444,40,92,43,21,22
445,1445,76,80,32,16,16
446,1446,80,84,81,41,40
447,1447,95,59,24,13,11
448,1448,67,69,222,112,110
449,1449,65,72,125,63,62
450,1450,87,68,42,20,22
451,1451,86,64,67,32,35
452,1452,68,76,49,24,25
453,1453,62,105,105,53,52
454,1454,69,80,55,27,28
455,1455,73,75,28,14,14
456,1456,62,88,74,37,37
457,1457,81,57,114,57,57
458,1458,90,52,56,29,27
459,1459,80,63,57,30,27
460,1460,40,98,62,31,31
461,1461,28,44,93,46,47
462,1462,27,67,10,5,5
463,1463,55,104,304,152,152
464,1464,72,94,104,52,52
465,1465,59,57,116,58,58
466,1466,73,66,72,36,36
467,1467,30,84,124,63,61
468,1468,30,87,106,53,53
469,1469,37,59,652,325,327
470,1470,60,136,66,33,33
471,1471,59,127,142,70,72
472,1472,64,80,34,17,17
473,1473,62,79,123,61,62
474,1474,80,66,102,50,52
475,1475,77,47,67,34,33
476,1476,83,44,101,50,51
477,1477,44,79,71,36,35
478,1478,38,75,75,39,36
479,1479,60,72,142,71,71
480,1480,61,113,184,92,92
481,1481,80,98,319,158,161
482,1482,86,78,308,154,154
483,1483,46,108,120,60,60
484,1484,45,40,32,16,16
485,1485,45,59,261,131,130
486,1486,48,72,236,117,119
487,1487,27,119,169,84,85
488,1488,11,107,117,60,57
489,1489,40,39,210,106,104
490,1490,16,5,16,8,8
491,1491,25,62,96,48,48
492,1492,25,65,51,26,25
493,1493,67,96,253,125,128
494,1494,69,96,183,91,92
495,1495,82,82,73,36,37
496,1496,85,84,359,182,177
497,1497,73,80,55,27,28
498,1498,78,80,106,52,54
499,1499,79,60,62,31,31
500,1500,69,95,102,52,50
501,1501,83,42,22,11,11
502,1502,56,109,72,36,36
503,1503,54,105,151,76,75
504,1504,56,97,139,69,70
505,1505,76,85,110,55,55
506,1506,25,119,176,87,89
507,1507,28,127,166,83,83
508,1508,35,119,95,48,47
509,1509,81,93,71,35,36
510,1510,79,95,325,163,162
511,1511,71,90,54,27,27
512,1512,82,50,41,20,21
513,1513,68,63,53,27,26
514,1514,66,53,326,162,164
515,1515,64,104,114,57,57
516,1516,76,93,243,122,121
517,1517,71,84,204,102,102
518,1518,72,84,152,76,76
519,1519,77,85,61,31,30
520,1520,77,86,69,34,35
521,1521,48,76,194,96,98
522,1522,58,114,128,64,64
523,1523,59,103,183,90,93
524,1524,59,101,176,88,88
525,1525,46,79,189,96,93
526,1526,68,64,107,54,53
527,1527,69,64,54,27,27
528,1528,27,82,223,112,111
529,1529,49,80,300,150,150
530,1530,56,85,71,36,35
531,1531,76,79,79,41,38
532,1532,69,94,51,25,26
533,1533,68,95,169,84,85
534,1534,79,79,25,13,12
535,1535,87,72,136,67,69
536,1536,88,66,105,52,53
537,1537,69,115,330,165,165
538,1538,70,82,93,47,46
539,1539,84,57,158,80,78
540,1540,92,59,14,7,7
541,1541,26,70,84,42,42
542,1542,56,88,34,17,17
543,1543,53,89,27,14,13
544,1544,50,148,94,48,46
545,1545,68,116,80,40,40
546,1546,70,105,196,98,98
547,1547,74,107,96,48,48
548,1548,64,38,133,67,66
549,1549,53,105,153,75,78
550,1550,67,94,34,17,17
551,1551,80,80,100,52,48
552,1552,59,85,148,73,75
553,1553,72,103,205,101,104
554,1554,56,113,143,70,73
555,1555,82,85,45,22,23
556,1556,42,119,64,32,32
557,1557,31,72,63,32,31
558,1558,53,104,107,53,54
559,1559,53,103,110,55,55
560,1560,56,115,55,27,28
561,1561,81,59,101,51,50
562,1562,83,95,102,51,51
563,1563,53,69,104,52,52
564,1564,59,105,245,122,123
565,1565,48,105,201,100,101
566,1566,82,94,134,67,67
567,1567,53,72,234,119,115
568,1568,84,60,36,17,19
569,1569,98,37,10,5,5
570,1570,56,70,77,38,39
571,1571,54,66,115,56,59
572,1572,49,69,82,41,41
573,1573,45,63,89,45,44
574,1574,50,52,34,17,17
575,1575,54,64,120,61,59
576,1576,84,75,47,23,24
577,1577,62,69,138,69,69
578,1578,57,66,97,48,49
579,1579,40,52,212,107,105
580,1580,60,138,26,13,13
581,1581,64,129,36,18,18
582,1582,68,148,63,31,32
583,1583,54,123,128,64,64
584,1584,79,52,14,7,7
585,1585,46,134,54,27,27
586,1586,35,145,67,34,33
587,1587,77,58,28,14,14
588,1588,99,47,6,3,3
589,1589,92,48,86,44,42
590,1590,78,92,227,114,113
591,1591,68,137,78,40,38
592,1592,36,43,134,67,67
593,1593,64,97,46,23,23
594,1594,67,90,152,76,76
595,1595,50,142,68,34,34
596,1596,46,142,133,68,65
597,1597,80,93,48,24,24
598,1598,59,89,110,55,55
599,1599,74,37,31,15,16
600,1600,54,83,58,29,29
601,1601,53,73,192,96,96
602,1602,81,64,136,66,70
603,1603,78,64,183,90,93
604,1604,72,104,111,56,55
605,1605,30,101,114,58,56
606,1606,56,53,32,16,16
607,1607,79,78,33,16,17
608,1608,80,96,56,28,28
609,1609,54,68,107,54,53
610,1610,27,78,179,89,90
611,1611,81,87,157,79,78
612,1612,76,68,134,66,68
613,1613,78,69,19,10,9
614,1614,45,44,73,38,35
615,1615,40,47,303,149,154
616,1616,58,72,97,50,47
617,1617,79,88,131,65,66
618,1618,34,66,198,97,101
619,1619,91,63,17,8,9
620,1620,54,133,86,43,43
621,1621,82,87,142,71,71
622,1622,86,77,63,31,32
623,1623,58,104,162,83,79
624,1624,63,138,47,23,24
625,1625,48,134,54,27,27
626,1626,67,129,10,5,5
627,1627,30,80,100,51,49
628,1628,65,123,179,90,89
629,1629,90,66,36,18,18
630,1630,74,94,126,63,63
631,1631,86,67,134,65,69
632,1632,76,104,175,88,87
633,1633,83,59,89,45,44
634,1634,65,80,52,26,26
635,1635,66,82,44,22,22
636,1636,69,57,133,66,67
637,1637,73,52,101,50,51
638,1638,35,72,212,109,103
639,1639,29,123,231,116,115
640,1640,79,63,260,131,129
641,1641,83,63,132,67,65
642,1642,56,117,72,36,36
643,1643,76,101,234,117,117
644,1644,89,29,102,51,51
645,1645,78,37,52,26,26
646,1646,64,93,130,64,66
647,1647,64,95,100,51,49
648,1648,74,67,124,62,62
649,1649,90,69,106,53,53
650,1650,89,69,78,39,39
651,1651,46,98,143,72,71
652,1652,19,89,44,22,22
653,1653,35,88,138,69,69
654,1654,81,97,216,109,107
655,1655,63,66,189,95,94
656,1656,86,72,67,33,34
657,1657,74,98,122,61,61
658,1658,61,104,213,104,109
659,1659,86,73,87,42,45
660,1660,80,36,32,16,16
661,1661,76,44,78,39,39
662,1662,78,77,158,79,79
663,1663,62,82,128,64,64
664,1664,40,94,88,44,44
665,1665,80,47,100,50,50
666,1666,77,40,151,76,75
667,1667,62,145,63,31,32
668,1668,47,77,46,23,23
669,1669,51,68,61,31,30
670,1670,69,88,98,48,50
671,1671,44,75,95,48,47
672,1672,48,108,137,69,68
673,1673,50,77,71,35,36
674,1674,65,96,44,22,22
675,1675,68,108,145,74,71
676,1676,30,108,388,193,195
677,1677,50,66,146,72,74
678,1678,50,63,223,113,110
679,1679,88,62,40,20,20
680,1680,86,68,119,59,60
681,1681,81,95,116,58,58
682,1682,69,105,233,116,117
683,1683,27,68,71,35,36
684,1684,85,43,102,51,51
685,1685,92,46,99,48,51
686,1686,85,70,42,20,22
687,1687,57,114,86,43,43
688,1688,59,117,169,84,85
689,1689,62,133,132,66,66
690,1690,71,69,42,21,21
691,1691,71,70,120,60,60
692,1692,32,119,56,29,27
693,1693,31,98,58,32,26
694,1694,39,68,421,208,213
695,1695,18,77,99,49,50
696,1696,83,60,92,46,46
697,1697,82,78,86,43,43
698,1698,73,87,82,40,42
699,1699,10,122,94,47,47
700,1700,65,126,159,79,80
701,1701,75,95,116,58,58
702,1702,85,75,46,23,23
703,1703,50,49,137,69,68
704,1704,54,53,55,27,28
705,1705,30,138,47,24,23
706,1706,79,74,91,45,46
707,1707,78,74,82,41,41
708,1708,74,44,80,38,42
709,1709,72,52,81,40,41
710,1710,86,66,72,37,35
711,1711,43,85,78,39,39
712,1712,63,75,120,60,60
713,1713,82,63,184,93,91
714,1714,51,118,124,63,61
715,1715,45,83,194,97,97
716,1716,27,136,90,44,46
717,1717,58,109,132,67,65
718,1718,72,98,217,108,109
719,1719,54,76,108,54,54
720,1720,48,62,74,37,37
721,1721,51,141,86,43,43
722,1722,85,80,203,102,101
723,1723,46,80,186,91,95
724,1724,45,70,61,32,29
725,1725,45,66,132,67,65
726,1726,86,63,72,38,34
727,1727,55,127,180,90,90
728,1728,72,62,193,97,96
729,1729,43,77,165,85,80
730,1730,69,84,190,94,96
731,1731,70,63,141,67,74
732,1732,81,90,94,47,47
733,1733,59,95,105,50,55
734,1734,80,95,149,74,75
735,1735,72,64,125,63,62
736,1736,58,99,79,40,39
737,1737,59,99,66,33,33
738,1738,44,70,135,66,69
739,1739,19,85,68,33,35
740,1740,64,53,89,43,46
741,1741,68,54,147,74,73
742,1742,25,99,148,73,75
743,1743,47,42,143,74,69
744,1744,45,43,53,25,28
745,1745,70,38,54,27,27
746,1746,69,79,251,127,124
747,1747,82,70,38,18,20
748,1748,45,60,60,29,31
749,1749,70,97,145,72,73
750,1750,64,86,79,41,38
751,1751,71,82,209,105,104
752,1752,92,57,56,28,28
753,1753,62,124,89,46,43
754,1754,66,135,59,30,29
755,1755,65,137,20,10,10
756,1756,73,72,66,33,33
757,1757,76,73,22,11,11
758,1758,35,52,224,111,113
759,1759,69,70,20,10,10
760,1760,68,103,132,66,66
761,1761,74,64,36,18,18
762,1762,72,66,55,28,27
763,1763,82,49,12,6,6
764,1764,28,115,54,27,27
765,1765,54,108,180,90,90
766,1766,71,92,135,68,67
767,1767,56,98,189,93,96
768,1768,76,70,91,46,45
769,1769,76,89,77,39,38
770,1770,83,78,165,83,82
771,1771,84,69,87,43,44
772,1772,36,139,36,18,18
773,1773,40,138,108,55,53
774,1774,45,79,252,126,126
775,1775,68,80,68,34,34
776,1776,64,79,40,20,20
777,1777,45,52,196,99,97
778,1778,76,52,157,78,79
779,1779,68,82,69,35,34
780,1780,77,38,133,67,66
781,1781,36,10,33,17,16
782,1782,30,11,53,29,24
783,1783,90,47,88,44,44
784,1784,74,105,124,61,63
785,1785,74,103,105,54,51
786,1786,76,105,206,103,103
787,1787,47,69,134,67,67
788,1788,78,83,63,31,32
789,1789,81,75,80,39,41
790,1790,55,80,54,27,27
791,1791,47,66,78,39,39
792,1792,56,133,93,46,47
793,1793,43,72,228,114,114
794,1794,54,114,57,28,29
795,1795,87,70,63,32,31
796,1796,68,144,55,28,27
797,1797,69,145,120,63,57
798,1798,91,67,101,50,51
799,1799,53,109,88,44,44
800,1800,73,40,64,31,33
801,1801,51,114,177,89,88
802,1802,46,92,67,33,34
803,1803,49,93,81,41,40
804,1804,77,90,24,12,12
805,1805,81,86,158,78,80
806,1806,72,78,49,23,26
807,1807,59,107,77,39,38
808,1808,50,104,150,75,75
809,1809,84,77,60,30,30
810,1810,50,103,124,62,62
811,1811,59,72,117,58,59
812,1812,62,92,331,163,168
813,1813,69,99,56,28,28
814,1814,33,96,92,43,49
815,1815,44,42,232,115,117
816,1816,45,38,56,28,28
817,1817,64,87,52,26,26
818,1818,75,73,31,15,16
819,1819,29,96,110,55,55
820,1820,71,76,235,117,118
821,1821,71,75,72,36,36
822,1822,34,108,12,6,6
823,1823,85,65,60,30,30
824,1824,43,86,29,15,14
825,1825,69,138,60,31,29
826,1826,28,67,49,24,25
827,1827,29,70,123,60,63
828,1828,27,66,50,26,24
829,1829,35,82,60,30,30
830,1830,79,77,45,23,22
831,1831,46,44,54,27,27
832,1832,66,104,118,57,61
833,1833,66,113,114,57,57
834,1834,67,119,42,21,21
835,1835,89,66,133,68,65
836,1836,79,92,155,77,78
837,1837,84,54,58,29,29
838,1838,28,121,210,105,105
839,1839,84,64,59,29,30
840,1840,82,62,73,37,36
841,1841,90,64,64,32,32
842,1842,84,35,11,5,6
843,1843,34,99,118,59,59
844,1844,40,70,189,95,94
845,1845,67,135,44,22,22
846,1846,43,98,64,31,33
847,1847,35,118,81,41,40
848,1848,58,59,119,59,60
849,1849,85,52,36,18,18
850,1850,82,68,88,44,44
851,1851,80,68,44,22,22
852,1852,75,90,29,14,15
853,1853,77,54,32,16,16
854,1854,84,74,10,5,5
855,1855,82,64,47,23,24
856,1856,88,74,72,35,37
857,1857,67,134,62,31,31
858,1858,84,68,116,58,58
859,1859,81,68,64,32,32
860,1860,44,82,68,34,34
861,1861,84,67,39,21,18
862,1862,71,89,98,49,49
863,1863,72,90,82,41,41
864,1864,85,68,111,55,56
865,1865,88,70,80,40,40
866,1866,44,98,78,39,39
867,1867,30,132,62,31,31
868,1868,32,132,99,50,49
869,1869,91,39,20,10,10
870,1870,78,33,74,36,38
871,1871,47,40,45,22,23
872,1872,51,44,24,12,12
873,1873,46,77,56,28,28
874,1874,18,131,55,28,27
875,1875,87,43,49,25,24
876,1876,74,58,109,54,55
877,1877,1,126,58,32,26
878,1878,79,40,115,56,59
879,1879,78,49,98,49,49
880,1880,49,87,92,46,46
881,1881,76,46,67,34,33
882,1882,43,66,168,84,84
883,1883,39,136,82,40,42
884,1884,46,97,16,8,8
885,1885,44,94,149,74,75
886,1886,69,93,256,128,128
887,1887,83,39,47,24,23
888,1888,26,63,58,29,29
889,1889,10,78,36,18,18
890,1890,49,46,32,18,14
891,1891,82,96,80,40,40
892,1892,45,85,80,40,40
893,1893,49,98,236,118,118
894,1894,74,92,46,25,21
895,1895,90,50,84,42,42
896,1896,45,88,116,57,59
897,1897,62,85,74,37,37
898,1898,40,63,86,42,44
899,1899,72,79,218,106,112
900,1900,35,99,131,65,66
901,1901,80,39,31,15,16
902,1902,47,96,220,109,111
903,1903,40,90,81,40,41
904,1904,91,66,62,31,31
905,1905,81,63,171,86,85
906,1906,69,60,140,71,69
907,1907,80,99,231,117,114
908,1908,69,74,128,64,64
909,1909,68,133,12,6,6
910,1910,57,105,259,127,132
911,1911,16,129,96,48,48
912,1912,69,87,125,62,63
913,1913,83,93,239,120,119
914,1914,81,92,48,24,24
915,1915,31,66,93,47,46
916,1916,63,105,58,31,27
917,1917,71,79,258,128,130
918,1918,65,146,109,56,53
919,1919,79,85,18,9,9
920,1920,69,92,186,93,93
921,1921,56,102,81,42,39
922,1922,87,50,78,40,38
923,1923,88,49,22,11,11
924,1924,90,46,31,16,15
925,1925,77,49,6,3,3
926,1926,73,84,84,42,42
927,1927,18,132,26,13,13
928,1928,73,93,71,36,35
929,1929,44,86,116,58,58
930,1930,41,80,77,39,38
931,1931,54,118,43,20,23
932,1932,53,139,51,26,25
933,1933,77,99,154,76,78
934,1934,83,53,33,16,17
935,1935,46,90,41,21,20
936,1936,68,66,53,27,26
937,1937,66,65,37,20,17
938,1938,69,85,122,61,61
939,1939,53,85,69,34,35
940,1940,93,48,8,4,4
941,1941,96,45,34,17,17
942,1942,43,44,106,53,53
943,1943,46,43,33,16,17
944,1944,73,64,60,30,30
945,1945,88,54,24,12,12
946,1946,72,88,130,65,65
947,1947,45,99,104,52,52
948,1948,67,86,68,34,34
949,1949,35,77,60,29,31
950,1950,40,87,72,36,36
951,1951,64,43,164,82,82
952,1952,76,69,10,5,5
953,1953,83,65,72,37,35
954,1954,79,70,70,35,35
955,1955,66,99,69,36,33
956,1956,78,89,216,110,106
957,1957,88,57,61,30,31
958,1958,26,21,83,39,44
959,1959,73,83,170,84,86
960,1960,81,82,45,23,22
961,1961,50,94,56,28,28
962,1962,80,87,126,61,65
963,1963,78,46,54,26,28
964,1964,80,44,234,117,117
965,1965,54,38,131,66,65
966,1966,86,48,38,19,19
967,1967,78,104,49,24,25
968,1968,86,70,18,10,8
969,1969,58,101,67,34,33
970,1970,40,96,170,85,85
971,1971,29,68,79,39,40
972,1972,80,92,155,77,78
973,1973,74,86,22,11,11
974,1974,65,119,57,28,29
975,1975,72,87,41,21,20
976,1976,121,52,6,3,3
977,1977,26,123,94,47,47
978,1978,64,59,63,31,32
979,1979,40,118,48,24,24
980,1980,74,69,50,25,25
981,1981,74,60,119,59,60
982,1982,80,85,104,52,52
983,1983,44,92,34,16,18
984,1984,59,38,90,45,45
985,1985,79,89,29,14,15
986,1986,85,63,60,30,30
987,1987,50,108,101,51,50
988,1988,98,43,25,12,13
989,1989,31,113,59,29,30
990,1990,76,72,62,31,31
991,1991,45,73,154,78,76
992,1992,45,68,108,54,54
993,1993,35,128,58,29,29
994,1994,72,82,123,60,63
995,1995,75,79,15,8,7
996,1996,62,30,87,40,47
997,1997,76,103,176,87,89
998,1998,30,97,42,21,21
999,1999,25,85,152,76,76
1000,2000,71,85,171,85,86
1001,2001,83,90,179,87,92
1002,2002,84,38,16,8,8
1003,2003,82,40,69,35,34
1004,2004,49,62,75,38,37
1005,2005,79,68,66,34,32
1006,2006,20,25,128,64,64
1007,2007,79,101,26,13,13
1008,2008,83,74,99,50,49
1009,2009,58,82,32,16,16
1010,2010,53,123,118,58,60
1011,2011,73,70,59,30,29
1012,2012,82,44,144,72,72
1013,2013,58,65,22,11,11
1014,2014,83,50,28,14,14
1015,2015,83,52,20,10,10
1016,2016,57,99,40,20,20
1017,2017,61,103,106,53,53
1018,2018,66,74,98,49,49
1019,2019,54,89,15,7,8
1020,2020,48,136,62,31,31
1021,2021,53,79,174,89,85
1022,2022,87,74,31,16,15
1023,2023,86,69,51,25,26
1024,2024,69,142,103,51,52
1025,2025,92,47,22,11,11
1026,2026,89,54,18,9,9
1027,2027,72,92,22,11,11
1028,2028,78,82,67,34,33
1029,2029,70,72,47,24,23
1030,2030,75,85,41,20,21
1031,2031,79,80,16,8,8
1032,2032,75,84,26,13,13
1033,2033,95,39,3,2,1
1034,2034,53,126,76,38,38
1035,2035,73,99,81,41,40
1036,2036,69,117,135,68,67
1037,2037,86,57,32,16,16
1038,2038,45,104,38,19,19
1039,2039,71,86,62,33,29
1040,2040,88,75,18,9,9
1041,2041,73,59,42,21,21
1042,2042,66,85,125,62,63
1043,2043,30,66,32,16,16
1044,2044,69,98,87,44,43
1045,2045,32,104,153,78,75
1046,2046,66,134,22,11,11
1047,2047,78,70,97,49,48
1048,2048,88,38,9,5,4
1049,2049,83,35,26,13,13
1050,2050,77,59,54,27,27
1051,2051,62,108,130,67,63
1052,2052,75,88,87,43,44
1053,2053,55,62,75,38,37
1054,2054,79,55,30,15,15
1055,2055,82,92,56,27,29
1056,2056,34,107,24,12,12
1057,2057,46,60,44,22,22
1058,2058,78,60,42,21,21
1059,2059,73,98,49,25,24
1060,2060,87,52,21,10,11
1061,2061,66,80,20,10,10
1062,2062,63,84,32,16,16
1063,2063,82,39,52,26,26
1064,2064,57,47,163,84,79
1065,2065,75,82,55,28,27
1066,2066,41,94,52,26,26
1067,2067,82,80,172,86,86
1068,2068,45,136,69,34,35
1069,2069,89,67,51,27,24
1070,2070,57,107,164,82,82
1071,2071,73,74,70,35,35
1072,2072,51,123,58,28,30
1073,2073,65,108,76,37,39
1074,2074,56,73,64,32,32
1075,2075,79,69,72,33,39
1076,2076,84,65,21,11,10
1077,2077,89,64,111,55,56
1078,2078,80,97,144,72,72
1079,2079,74,82,38,18,20
1080,2080,43,95,29,15,14
1081,2081,64,70,156,78,78
1082,2082,82,56,30,15,15
1083,2083,48,58,88,43,45
1084,2084,78,84,82,41,41
1085,2085,56,82,74,37,37
1086,2086,62,86,69,35,34
1087,2087,40,77,38,17,21
1088,2088,77,98,142,71,71
1089,2089,79,104,96,48,48
1090,2090,48,59,68,34,34
1091,2091,49,43,16,7,9
1092,2092,49,44,38,19,19
1093,2093,49,90,51,25,26
1094,2094,66,145,31,13,18
1095,2095,76,82,39,19,20
1096,2096,52,83,18,9,9
1097,2097,87,77,14,7,7
1098,2098,94,45,66,33,33
1099,2099,71,88,70,35,35
1100,2100,74,88,56,28,28
1101,2101,49,76,139,70,69
1102,2102,59,84,89,45,44
1103,2103,75,78,63,32,31
1104,2104,74,83,57,29,28
1105,2105,25,145,52,27,25
1106,2106,83,56,18,9,9
1107,2107,66,83,59,29,30
1108,2108,73,78,59,31,28
1109,2109,78,76,14,7,7
1110,2110,93,60,34,16,18
1111,2111,69,59,96,48,48
1112,2112,1,117,51,26,25
1113,2113,83,92,116,59,57
1114,2114,35,38,40,21,19
1115,2115,21,114,132,66,66
1116,2116,9,58,36,20,16
1117,2117,76,60,60,30,30
1118,2118,83,34,56,28,28
1119,2119,82,76,22,11,11
1120,2120,57,125,133,66,67
1121,2121,69,103,136,70,66
1122,2122,77,57,67,33,34
1123,2123,55,78,167,84,83
1124,2124,77,78,60,30,30
1125,2125,80,74,26,14,12
1126,2126,79,73,36,18,18
1127,2127,76,87,80,40,40
1128,2128,92,63,19,11,8
1129,2129,95,53,14,7,7
1130,2130,45,90,71,35,36
1131,2131,62,73,68,34,34
1132,2132,42,137,56,29,27
1133,2133,57,145,33,17,16
1134,2134,72,20,19,10,9
1135,2135,30,99,30,15,15
1136,2136,47,119,95,47,48
1137,2137,40,114,47,23,24
1138,2138,55,105,91,45,46
1139,2139,77,83,50,25,25
1140,2140,35,135,86,44,42
1141,2141,67,98,153,78,75
1142,2142,58,70,54,27,27
1143,2143,64,85,96,49,47
1144,2144,85,59,20,10,10
1145,2145,81,60,39,20,19
1146,2146,73,73,33,17,16
1147,2147,79,76,36,18,18
1148,2148,57,126,164,83,81
1149,2149,38,30,91,45,46
1150,2150,76,65,70,35,35
1151,2151,54,88,80,40,40
1152,2152,46,87,43,23,20
1153,2153,68,126,72,37,35
1154,2154,79,75,39,19,20
1155,2155,81,67,10,4,6
1156,2156,10,97,29,15,14
1157,2157,77,69,83,42,41
1158,2158,76,78,58,29,29
1159,2159,40,44,95,48,47
1160,2160,72,102,87,45,42
1161,2161,75,80,44,22,22
1162,2162,41,42,57,29,28
1163,2163,6,141,63,32,31
1164,2164,69,67,27,15,12
1165,2165,71,72,78,39,39
1166,2166,70,57,81,41,40
1167,2167,37,80,42,21,21
1168,2168,45,42,48,24,24
1169,2169,16,24,140,71,69
1170,2170,73,86,111,56,55
1171,2171,72,77,8,4,4
1172,2172,63,82,50,25,25
1173,2173,64,132,24,12,12
1174,2174,75,76,56,28,28
1175,2175,100,54,2,1,1
1176,2176,80,79,20,10,10
1177,2177,77,97,58,29,29
1178,2178,86,59,67,33,34
1179,2179,83,68,37,18,19
1180,2180,88,21,15,8,7
1181,2181,65,88,80,40,40
1182,2182,68,83,90,45,45
1183,2183,45,65,64,33,31
1184,2184,52,25,31,16,15
1185,2185,86,76,36,18,18
1186,2186,84,40,79,41,38
1187,2187,76,92,92,46,46
1188,2188,78,93,32,16,16
1189,2189,80,72,79,39,40
1190,2190,78,103,239,118,121
1191,2191,64,82,78,39,39
1192,2192,81,78,43,22,21
1193,2193,92,66,19,9,10
1194,2194,95,55,6,3,3
1195,2195,89,65,44,22,22
1196,2196,44,78,82,41,41
1197,2197,40,88,32,16,16
1198,2198,58,80,91,45,46
1199,2199,87,69,25,12,13
1200,2200,80,62,40,20,20
1201,2201,73,103,71,36,35
1202,2202,78,94,74,37,37
1203,2203,92,30,27,14,13
1204,2204,117,43,2,1,1
1205,2205,78,75,46,23,23
1206,2206,69,86,64,33,31
1207,2207,55,83,72,36,36
1208,2208,68,145,26,13,13
1209,2209,66,133,36,18,18
1210,2210,73,85,112,56,56
1211,2211,74,109,22,11,11
1212,2212,72,80,179,89,90
1213,2213,76,77,64,32,32
1214,2214,88,64,77,37,40
1215,2215,81,72,43,21,22
1216,2216,64,96,97,47,50
1217,2217,80,70,36,17,19
1218,2218,74,85,52,26,26
1219,2219,30,89,44,22,22
1220,2220,61,118,49,24,25
1221,2221,80,57,61,31,30
1222,2222,78,85,83,41,42
1223,2223,84,37,73,37,36
1224,2224,63,78,46,23,23
1225,2225,40,82,65,32,33
1226,2226,71,60,69,35,34
1227,2227,82,48,23,11,12
1228,2228,49,40,4,2,2
1229,2229,77,84,26,13,13
1230,2230,92,62,40,20,20
1231,2231,74,78,29,14,15
1232,2232,96,34,6,3,3
1233,2233,74,72,20,10,10
1234,2234,76,86,25,13,12
1235,2235,92,65,29,14,15
1236,2236,50,42,17,8,9
1237,2237,80,53,50,25,25
1238,2238,82,53,24,12,12
1239,2239,79,94,102,51,51
1240,2240,92,42,51,26,25
1241,2241,92,50,39,19,20
1242,2242,81,77,22,11,11
1243,2243,94,50,8,4,4
1244,2244,87,75,21,11,10
1245,2245,85,60,36,18,18
1246,2246,35,125,44,22,22
1247,2247,77,87,8,4,4
1248,2248,79,96,100,50,50
1249,2249,73,63,48,23,25
1250,2250,53,87,50,25,25
1251,2251,30,68,42,21,21
1252,2252,49,60,86,43,43
1253,2253,28,66,21,11,10
1254,2254,67,76,73,37,36
1255,2255,94,59,21,10,11
1256,2256,86,74,22,11,11
1257,2257,67,136,41,20,21
1258,2258,1,145,86,43,43
1259,2259,58,83,93,47,46
1260,2260,87,64,29,15,14
1261,2261,49,72,117,58,59
1262,2262,81,66,89,45,44
1263,2263,30,67,33,17,16
1264,2264,88,69,19,10,9
1265,2265,40,97,22,11,11
1266,2266,84,49,39,20,19
1267,2267,90,68,20,10,10
1268,2268,17,116,66,33,33
1269,2269,76,83,34,17,17
1270,2270,80,76,20,10,10
1271,2271,81,69,30,14,16
1272,2272,31,68,13,7,6
1273,2273,78,56,30,15,15
1274,2274,30,3,13,6,7
1275,2275,31,108,16,8,8
1276,2276,101,44,4,2,2
1277,2277,79,72,22,11,11
1278,2278,38,20,40,19,21
1279,2279,65,77,69,34,35
1280,2280,40,123,46,23,23
1281,2281,75,83,16,8,8
1282,2282,76,90,43,23,20
1283,2283,74,84,34,17,17
1284,2284,81,76,52,26,26
1285,2285,82,75,22,11,11
1286,2286,76,74,15,7,8
1287,2287,82,72,34,18,16
1288,2288,50,92,41,20,21
1289,2289,94,49,4,2,2
1290,2290,59,53,36,18,18
1291,2291,96,58,10,5,5
1292,2292,97,48,8,4,4
1293,2293,94,52,14,7,7
1294,2294,85,76,42,23,19
1295,2295,36,124,39,19,20
1296,2296,40,85,25,13,12
1297,2297,64,133,61,30,31
1298,2298,78,73,32,16,16
1299,2299,101,55,16,9,7
1300,2300,85,73,42,20,22
1301,2301,83,54,18,9,9
1302,2302,80,78,14,7,7
1303,2303,77,82,18,9,9
1304,2304,152,67,2,1,1
1305,2305,69,147,44,22,22
1306,2306,74,87,20,10,10
1307,2307,45,10,8,4,4
1308,2308,85,64,42,21,21
1309,2309,83,75,20,10,10
1310,2310,78,67,22,11,11
1311,2311,45,145,26,13,13
1312,2312,87,54,32,16,16
1313,2313,83,73,22,11,11
1314,2314,77,88,10,5,5
1315,2315,41,117,26,13,13
1316,2316,64,139,36,18,18
1317,2317,87,65,24,11,13
1318,2318,41,86,72,36,36
1319,2319,84,76,26,13,13
1320,2320,97,55,4,2,2
1321,2321,16,18,37,18,19
1322,2322,71,64,38,19,19
1323,2323,76,75,12,6,6
1324,2324,50,43,53,26,27
1325,2325,93,62,34,17,17
1326,2326,31,97,15,8,7
1327,2327,88,50,4,2,2
1328,2328,85,40,20,9,11
1329,2329,98,55,3,2,1
1330,2330,85,72,6,3,3
1331,2331,45,96,26,13,13
1332,2332,30,96,4,2,2
1333,2333,68,88,19,10,9
1334,2334,107,34,4,2,2
1335,2335,91,37,8,4,4
1336,2336,26,68,38,18,20
1337,2337,81,70,22,11,11
1338,2338,49,39,25,14,11
1339,2339,71,87,38,19,19
1340,2340,89,59,6,3,3
1341,2341,97,27,2,1,1
1342,2342,76,84,10,5,5
1343,2343,79,82,12,7,5
1344,2344,96,48,8,4,4
1345,2345,84,72,11,5,6
1346,2346,85,69,7,3,4
1347,2347,69,121,4,2,2
1348,2348,84,70,24,12,12
1349,2349,100,53,2,1,1
1350,2350,73,76,12,6,6
1351,2351,74,76,2,1,1
1352,2352,84,73,4,2,2
1353,2353,72,86,12,6,6
1354,2354,108,45,2,1,1
1355,2355,60,54,14,7,7
1356,2356,87,59,6,3,3
1357,2357,80,75,11,5,6
1358,2358,92,64,18,9,9
1359,2359,109,39,2,1,1
1360,2360,79,34,17,8,9
1361,2361,32,114,2,1,1
1362,2362,116,47,6,4,2
1363,2363,65,83,15,7,8
1364,2364,145,62,2,1,1
1365,2365,75,87,16,8,8
1366,2366,77,79,4,2,2
1367,2367,67,82,4,2,2
1368,2368,114,36,1,1,0
1369,2369,67,133,6,3,3
1370,2370,66,84,28,14,14
1371,2371,96,52,4,2,2
1372,2372,113,48,4,2,2
1373,2373,92,54,3,1,2
1374,2374,90,56,20,10,10
1375,2375,95,37,2,2,0
1376,2376,98,39,10,5,5
1377,2377,40,148,5,2,3
1378,2378,82,74,2,1,1
1379,2379,105,46,4,2,2
1380,2380,75,72,10,5,5
1381,2381,93,53,2,1,1
1382,2382,100,50,2,1,1
1383,2383,111,52,2,1,1
1384,2384,96,44,4,2,2
1385,2385,80,69,2,1,1
1386,2386,96,43,8,4,4
1387,2387,97,11,4,2,2
1388,2388,125,27,2,1,1
1389,2389,90,62,9,4,5
1390,2390,102,53,1,1,0
1391,2391,83,38,6,3,3
1392,2392,96,50,6,3,3
1393,2393,97,58,2,1,1
1394,2394,82,65,6,3,3
1395,2395,116,40,10,5,5
1396,2396,113,42,2,1,1
1397,2397,90,65,4,2,2
1398,2398,82,52,10,5,5
1399,2399,99,54,2,1,1
1400,2400,46,48,6,3,3
1401,2401,108,36,2,1,1
1402,2402,124,46,1,1,0
1403,2403,45,135,2,1,1
1404,2404,139,52,1,0,1
1405,2405,95,47,2,1,1
1406,2406,107,50,1,0,1
