id,unicode,X,Y,population,travellers,visitors
1,1001,12697,2316,73995,47636,26359
2,1002,12670,2329,9137,5708,3429
3,1003,12669,2329,42094,18220,23874
4,1004,12682,2319,5875,2959,2916
5,1005,12686,2318,24657,14386,10271
6,1006,12680,2317,22238,11960,10278
7,1007,12699,2318,92546,44799,47747
8,1008,12701,2324,2213,665,1548
9,1009,12700,2318,63702,32264,31438
10,1010,12699,2319,53579,29321,24258
11,1011,12698,2317,45185,24520,20665
12,1012,12694,2318,25528,13670,11858
13,1013,12696,2315,24763,12002,12761
14,1014,12694,2315,10952,5806,5146
15,1015,12696,2316,59251,32264,26987
16,1016,12698,2318,45848,24423,21425
17,1017,12697,2318,27423,14412,13011
18,1018,12688,2317,9532,5169,4363
19,1019,12689,2317,10105,5337,4768
20,1020,12698,2316,47029,8660,38369
21,1021,12702,2318,121525,65822,55703
22,1022,12703,2318,192003,109307,82696
23,1023,12701,2318,63530,33182,30348
24,1024,12703,2317,135279,59330,75949
25,1025,12705,2319,34480,17913,16567
26,1026,12711,2323,416,55,361
27,1027,12708,2321,2879,741,2138
28,1028,12702,2317,48974,26072,22902
29,1029,12704,2318,52077,27645,24432
30,1030,12704,2319,84548,44483,40065
31,1031,12703,2321,24411,11892,12519
32,1032,12692,2318,25750,13321,12429
33,1033,12694,2319,30089,16334,13755
34,1034,12694,2320,22433,10832,11601
35,1035,12699,2321,15643,7833,7810
36,1036,12697,2320,10250,5041,5209
37,1037,12699,2317,40202,21059,19143
38,1038,12695,2317,49545,27663,21882
39,1039,12696,2317,66482,33105,33377
40,1040,12695,2316,47118,24242,22876
41,1041,12697,2317,52440,27098,25342
42,1042,12706,2319,14283,7296,6987
43,1043,12705,2321,24649,12031,12618
44,1044,12682,2316,37682,21814,15868
45,1045,12683,2317,6839,3139,3700
46,1046,12684,2317,8749,3761,4988
47,1047,12684,2318,20712,11418,9294
48,1048,12686,2317,12172,6271,5901
49,1049,12687,2318,17535,9433,8102
50,1050,12687,2317,3115,1918,1197
51,1051,12693,2317,23415,11808,11607
52,1052,12693,2316,36663,19879,16784
53,1053,12687,2319,3963,1402,2561
54,1054,12686,2321,1910,842,1068
55,1055,12701,2319,39446,20533,18913
56,1056,12691,2318,11201,5523,5678
57,1057,12695,2318,42357,21441,20916
58,1058,12702,2325,22305,12128,10177
59,1059,12702,2326,5730,2278,3452
60,1060,12695,2319,25956,12570,13386
61,1061,12699,2320,14259,6882,7377
62,1062,12697,2319,16805,8734,8071
63,1063,12694,2316,35737,18004,17733
64,1064,12695,2315,12369,5482,6887
65,1065,12723,2324,640,270,370
66,1066,12714,2319,1244,810,434
67,1067,12716,2319,1462,552,910
68,1068,12708,2320,16241,8855,7386
69,1069,12683,2319,6565,3085,3480
70,1070,12682,2317,10434,5435,4999
71,1071,12681,2316,34560,18784,15776
72,1072,12680,2316,13867,6464,7403
73,1073,12701,2320,36950,19828,17122
74,1074,12704,2321,23783,11798,11985
75,1075,12681,2320,1213,406,807
76,1076,12681,2319,8815,4405,4410
77,1077,12683,2318,26831,13995,12836
78,1078,12695,2320,22704,11890,10814
79,1079,12702,2323,14068,5747,8321
80,1080,12701,2321,15727,7646,8081
81,1081,12700,2321,11812,5552,6260
82,1082,12694,2317,16943,8614,8329
83,1083,12691,2317,22945,11583,11362
84,1084,12681,2317,33954,18598,15356
85,1085,12684,2314,19018,9355,9663
86,1086,12681,2318,19900,10093,9807
87,1087,12688,2318,7316,3584,3732
88,1088,12692,2317,38233,20616,17617
89,1089,12695,2321,7253,3140,4113
90,1090,12696,2321,14383,7395,6988
91,1091,12694,2325,13347,6439,6908
92,1092,12697,2315,31602,13696,17906
93,1093,12682,2318,15076,7859,7217
94,1094,12686,2326,90,26,64
95,1095,12681,2314,16569,8218,8351
96,1096,12680,2313,4718,1988,2730
97,1097,12681,2313,12225,6178,6047
98,1098,12677,2312,594,76,518
99,1099,12682,2313,8301,3303,4998
100,1100,12670,2332,2021,911,1110
101,1101,12689,2318,7364,3262,4102
102,1102,12703,2324,17451,8862,8589
103,1103,12703,2319,52250,27669,24581
104,1104,12696,2318,20252,9801,10451
105,1105,12701,2317,6137,3096,3041
106,1106,12696,2320,14485,7499,6986
107,1107,12706,2325,6833,3077,3756
108,1108,12702,2324,22743,12770,9973
109,1109,12703,2325,12467,6557,5910
110,1110,12704,2320,35756,17689,18067
111,1111,12704,2325,11893,6285,5608
112,1112,12697,2321,14500,7214,7286
113,1113,12696,2319,18658,9063,9595
114,1114,12687,2332,860,366,494
115,1115,12695,2324,19351,9771,9580
116,1116,12679,2319,16605,9578,7027
117,1117,12679,2318,1491,439,1052
118,1118,12700,2320,36619,19085,17534
119,1119,12694,2321,9364,4400,4964
120,1120,12704,2326,2131,624,1507
121,1121,12690,2317,10999,5602,5397
122,1122,12681,2312,4707,2247,2460
123,1123,12684,2322,10450,5287,5163
124,1124,12703,2323,13065,5505,7560
125,1125,12701,2327,3651,1740,1911
126,1126,12680,2322,3855,1479,2376
127,1127,12680,2318,16737,8526,8211
128,1128,12674,2324,1551,700,851
129,1129,12680,2311,4863,2064,2799
130,1130,12709,2320,9880,4805,5075
131,1131,12711,2320,633,118,515
132,1132,12710,2320,1868,735,1133
133,1133,12700,2319,33295,16634,16661
134,1134,12702,2319,36123,19287,16836
135,1135,12696,2327,7609,3888,3721
136,1136,12696,2325,2750,1208,1542
137,1137,12706,2321,512,121,391
138,1138,12704,2322,15257,7893,7364
139,1139,12704,2323,4857,1510,3347
140,1140,12702,2320,20843,10091,10752
141,1141,12703,2322,21556,9448,12108
142,1142,12705,2320,27617,13351,14266
143,1143,12679,2320,23126,12225,10901
144,1144,12680,2315,9498,4587,4911
145,1145,12670,2331,2136,1150,986
146,1146,12693,2320,9953,4415,5538
147,1147,12702,2321,17731,8837,8894
148,1148,12693,2318,15197,7814,7383
149,1149,12689,2316,2267,1055,1212
150,1150,12686,2320,5366,2558,2808
151,1151,12693,2321,1559,430,1129
152,1152,12691,2319,13643,6279,7364
153,1153,12703,2320,32584,16629,15955
154,1154,12692,2330,14240,7628,6612
155,1155,12707,2320,3520,1871,1649
156,1156,12707,2319,1671,711,960
157,1157,12669,2334,99,50,49
158,1158,12694,2326,10011,5158,4853
159,1159,12678,2314,2237,861,1376
160,1160,12676,2321,10806,5890,4916
161,1161,12693,2319,7369,3884,3485
162,1162,12682,2314,6681,2838,3843
163,1163,12682,2315,15373,7866,7507
164,1164,12684,2320,6526,3317,3209
165,1165,12683,2320,3766,1666,2100
166,1166,12681,2315,20962,10529,10433
167,1167,12680,2312,10333,5897,4436
168,1168,12677,2313,906,178,728
169,1169,12680,2314,2618,817,1801
170,1170,12677,2320,15193,8239,6954
171,1171,12677,2321,13910,7293,6617
172,1172,12678,2320,28681,14720,13961
173,1173,12683,2314,1042,336,706
174,1174,12678,2321,27544,14940,12604
175,1175,12679,2317,6110,2085,4025
176,1176,12679,2315,7023,3260,3763
177,1177,12683,2316,7550,3801,3749
178,1178,12688,2320,4089,1673,2416
179,1179,12696,2323,993,328,665
180,1180,12697,2327,3034,1309,1725
181,1181,12670,2328,1777,869,908
182,1182,12675,2321,8073,3975,4098
183,1183,12678,2313,208,11,197
184,1184,12683,2326,454,178,276
185,1185,12698,2322,956,221,735
186,1186,12698,2327,2542,1155,1387
187,1187,12697,2328,5884,3251,2633
188,1188,12702,2327,3275,1069,2206
189,1189,12684,2316,5734,2293,3441
190,1190,12682,2312,3850,1663,2187
191,1191,12724,2324,2061,972,1089
192,1192,12715,2319,5675,3142,2533
193,1193,12680,2319,4565,2726,1839
194,1194,12678,2323,3364,1410,1954
195,1195,12677,2323,8879,4150,4729
196,1196,12678,2322,15737,7927,7810
197,1197,12677,2322,20347,11369,8978
198,1198,12683,2323,431,46,385
199,1199,12672,2325,1208,527,681
200,1200,12680,2320,6133,2412,3721
201,1201,12705,2322,17467,7875,9592
202,1202,12699,2332,10,4,6
203,1203,12698,2333,487,194,293
204,1204,12697,2333,292,117,175
205,1205,12697,2332,350,147,203
206,1206,12696,2328,5573,2933,2640
207,1207,12684,2319,3302,1091,2211
208,1208,12688,2316,986,374,612
209,1209,12692,2319,6940,3552,3388
210,1210,12678,2310,135,14,121
211,1211,12691,2320,917,180,737
212,1212,12698,2319,6494,3451,3043
213,1213,12702,2322,13929,7561,6368
214,1214,12705,2327,2273,774,1499
215,1215,12696,2322,1380,495,885
216,1216,12723,2336,1100,532,568
217,1217,12717,2335,822,259,563
218,1218,12717,2336,6120,3676,2444
219,1219,12708,2324,947,516,431
220,1220,12700,2317,6262,3270,2992
221,1221,12698,2325,68,34,34
222,1222,12697,2329,4829,2453,2376
223,1223,12695,2323,2724,1666,1058
224,1224,12679,2321,11941,6021,5920
225,1225,12682,2320,2327,620,1707
226,1226,12686,2316,1896,693,1203
227,1227,12709,2321,1414,295,1119
228,1228,12687,2320,6556,2706,3850
229,1229,12692,2328,12794,6812,5982
230,1230,12696,2326,9326,4752,4574
231,1231,12709,2324,1411,442,969
232,1232,12716,2320,1895,804,1091
233,1233,12685,2316,1058,344,714
234,1234,12706,2320,1586,564,1022
235,1235,12685,2320,2358,905,1453
236,1236,12707,2325,5238,2395,2843
237,1237,12685,2317,2229,1072,1157
238,1238,12693,2329,6031,3385,2646
239,1239,12691,2330,6864,3350,3514
240,1240,12706,2326,2658,939,1719
241,1241,12708,2325,6978,3760,3218
242,1242,12703,2326,4466,1904,2562
243,1243,12706,2330,134,69,65
244,1244,12700,2334,413,210,203
245,1245,12707,2326,3060,1382,1678
246,1246,12707,2327,1279,549,730
247,1247,12705,2325,13376,7573,5803
248,1248,12709,2328,752,326,426
249,1249,12690,2333,458,125,333
250,1250,12698,2329,2008,873,1135
251,1251,12712,2329,2836,1489,1347
252,1252,12714,2327,191,68,123
253,1253,12715,2333,597,363,234
254,1254,12710,2328,1054,476,578
255,1255,12712,2330,439,214,225
256,1256,12705,2326,7317,3474,3843
257,1257,12704,2324,3617,1141,2476
258,1258,12705,2324,2720,676,2044
259,1259,12703,2331,421,163,258
260,1260,12703,2329,615,240,375
261,1261,12695,2333,792,434,358
262,1262,12704,2328,1402,478,924
263,1263,12708,2332,109,54,55
264,1266,12708,2327,559,214,345
265,1267,12716,2334,1129,441,688
266,1268,12701,2325,3948,1278,2670
267,1269,12710,2327,107,19,88
268,1270,12700,2328,650,347,303
269,1271,12695,2328,6875,3463,3412
270,1272,12688,2331,901,479,422
271,1273,12690,2329,1205,477,728
272,1274,12707,2332,469,157,312
273,1275,12710,2334,6,1,5
274,1276,12708,2333,133,73,60
275,1277,12701,2329,256,58,198
276,1278,12707,2328,176,76,100
277,1279,12704,2334,1861,962,899
278,1280,12703,2332,757,262,495
279,1281,12707,2330,45,11,34
280,1282,12693,2328,6564,3396,3168
281,1283,12699,2328,1833,960,873
282,1284,12703,2333,253,111,142
283,1285,12699,2327,1247,440,807
284,1286,12713,2329,1423,703,720
285,1287,12711,2328,1240,642,598
286,1288,12703,2330,204,59,145
287,1289,12707,2321,115,22,93
288,1290,12680,2343,80,40,40
289,1291,12681,2343,54,25,29
290,1292,12719,2325,2,1,1
291,1293,12705,2333,827,412,415
292,1294,12700,2336,73,25,48
293,1295,12701,2334,300,165,135
294,1296,12702,2335,24,12,12
295,1297,12703,2334,857,431,426
296,1298,12706,2329,272,125,147
297,1299,12706,2331,290,114,176
298,1300,12694,2328,6345,3409,2936
299,1301,12698,2326,404,59,345
300,1302,12711,2329,1337,517,820
301,1303,12675,2329,321,24,297
302,1304,12694,2327,6441,3425,3016
303,1305,12676,2320,5671,2293,3378
304,1306,12675,2320,2652,1197,1455
305,1307,12674,2320,1972,780,1192
306,1308,12674,2321,6052,2859,3193
307,1309,12676,2323,11191,6564,4627
308,1310,12677,2324,1605,516,1089
309,1311,12676,2324,3427,1722,1705
310,1312,12676,2322,18848,9738,9110
311,1313,12679,2322,5586,2706,2880
312,1314,12675,2322,9661,5467,4194
313,1315,12674,2322,6985,3265,3720
314,1316,12673,2322,1271,575,696
315,1317,12669,2324,115,38,77
316,1318,12670,2325,49,16,33
317,1319,12673,2325,476,161,315
318,1320,12675,2323,2668,1341,1327
319,1321,12675,2325,468,257,211
320,1322,12675,2324,2714,1317,1397
321,1323,12674,2326,4734,2300,2434
322,1324,12678,2319,5482,2365,3117
323,1325,12673,2324,3278,1454,1824
324,1326,12672,2338,758,336,422
325,1327,12671,2328,1458,582,876
326,1328,12680,2321,5474,2286,3188
327,1329,12677,2325,456,67,389
328,1330,12673,2321,1845,625,1220
329,1331,12672,2322,78,24,54
330,1332,12671,2325,143,39,104
331,1333,12670,2324,4,2,2
332,1334,12674,2330,876,340,536
333,1335,12674,2329,756,322,434
334,1336,12674,2325,3173,1658,1515
335,1337,12674,2328,796,357,439
336,1338,12677,2330,177,19,158
337,1339,12693,2331,14669,7073,7596
338,1340,12692,2331,7223,3747,3476
339,1341,12686,2333,333,203,130
340,1342,12669,2325,18,8,10
341,1343,12672,2324,2017,815,1202
342,1344,12682,2322,1347,431,916
343,1345,12703,2327,383,42,341
344,1346,12691,2331,2851,1117,1734
345,1347,12671,2330,23,4,19
346,1348,12667,2343,27,9,18
347,1349,12669,2341,14,4,10
348,1350,12681,2321,2440,771,1669
349,1351,12674,2327,2135,899,1236
350,1352,12672,2343,36,12,24
351,1353,12672,2328,1315,574,741
352,1354,12676,2319,608,162,446
353,1355,12673,2326,1419,831,588
354,1356,12672,2327,1793,725,1068
355,1357,12669,2331,721,321,400
356,1358,12670,2326,23,13,10
357,1359,12671,2327,673,229,444
358,1360,12671,2324,426,77,349
359,1361,12671,2342,68,19,49
360,1362,12671,2329,2623,1460,1163
361,1363,12673,2323,891,525,366
362,1364,12681,2323,971,237,734
363,1365,12681,2322,1139,257,882
364,1366,12673,2320,129,16,113
365,1367,12670,2334,160,59,101
366,1368,12673,2338,310,132,178
367,1369,12671,2335,424,226,198
368,1371,12670,2345,86,41,45
369,1372,12681,2331,458,246,212
370,1373,12670,2330,754,384,370
371,1374,12668,2331,644,315,329
372,1375,12670,2339,118,63,55
373,1376,12671,2333,437,185,252
374,1377,12672,2334,66,11,55
375,1378,12667,2332,409,158,251
376,1379,12667,2345,72,17,55
377,1380,12666,2345,82,34,48
378,1381,12680,2323,483,178,305
379,1382,12679,2336,282,125,157
380,1383,12671,2332,158,46,112
381,1384,12674,2323,983,319,664
382,1385,12667,2333,160,62,98
383,1386,12671,2336,465,233,232
384,1387,12675,2330,250,82,168
385,1388,12677,2319,1196,260,936
386,1389,12695,2326,1542,537,1005
387,1390,12668,2335,137,38,99
388,1391,12669,2335,65,17,48
389,1392,12676,2331,84,37,47
390,1393,12672,2326,571,149,422
391,1394,12672,2333,159,59,100
392,1395,12672,2323,870,250,620
393,1396,12682,2332,1427,817,610
394,1397,12682,2333,274,116,158
395,1398,12671,2334,504,236,268
396,1399,12684,2321,4747,2344,2403
397,1400,12687,2323,515,171,344
398,1401,12685,2322,1749,760,989
399,1402,12681,2325,111,45,66
400,1403,12668,2340,37,8,29
401,1404,12669,2338,144,77,67
402,1405,12681,2324,125,38,87
403,1406,12694,2324,4489,1571,2918
404,1407,12678,2324,424,83,341
405,1408,12680,2330,230,72,158
406,1409,12716,2335,4179,2144,2035
407,1410,12715,2332,788,375,413
408,1411,12713,2330,629,347,282
409,1412,12694,2334,865,476,389
410,1413,12693,2330,14130,7721,6409
411,1414,12681,2328,469,167,302
412,1415,12669,2330,504,255,249
413,1416,12681,2330,334,179,155
414,1417,12668,2333,308,121,187
415,1418,12678,2330,124,13,111
416,1419,12722,2337,3204,1735,1469
417,1420,12721,2337,2761,1558,1203
418,1421,12698,2330,592,267,325
419,1422,12695,2331,2689,1240,1449
420,1423,12697,2326,2457,769,1688
421,1424,12706,2327,492,75,417
422,1425,12704,2332,466,185,281
423,1426,12699,2334,490,223,267
424,1427,12693,2326,5601,2406,3195
425,1428,12694,2329,8707,4801,3906
426,1429,12695,2329,3656,1685,1971
427,1430,12693,2327,6461,2812,3649
428,1431,12701,2326,1684,518,1166
429,1432,12704,2327,1087,430,657
430,1433,12691,2327,987,249,738
431,1434,12696,2330,3717,1675,2042
432,1435,12701,2328,120,33,87
433,1436,12702,2331,89,22,67
434,1437,12702,2333,122,38,84
435,1438,12700,2327,363,165,198
436,1439,12715,2336,2016,1028,988
437,1440,12716,2336,9004,5372,3632
438,1441,12701,2323,1566,462,1104
439,1442,12679,2316,942,190,752
440,1443,12690,2318,2483,807,1676
441,1444,12713,2333,304,116,188
442,1445,12698,2321,1827,512,1315
443,1446,12696,2324,1441,443,998
444,1447,12695,2325,805,239,566
445,1448,12701,2322,4621,1664,2957
446,1449,12705,2318,8847,3446,5401
447,1450,12682,2324,101,24,77
448,1451,12688,2319,2801,1145,1656
449,1452,12698,2320,2159,1349,810
450,1453,12685,2323,1265,559,706
451,1454,12680,2331,223,61,162
452,1455,12682,2328,299,84,215
453,1456,12685,2324,561,209,352
454,1457,12698,2328,727,378,349
455,1458,12685,2318,4472,2429,2043
456,1459,12694,2337,503,267,236
457,1460,12695,2338,86,47,39
458,1461,12697,2337,627,306,321
459,1462,12697,2336,1658,728,930
460,1463,12696,2336,1372,682,690
461,1464,12694,2336,1319,694,625
462,1465,12694,2333,995,561,434
463,1466,12692,2316,6131,2963,3168
464,1467,12665,2336,32,5,27
465,1468,12692,2326,585,84,501
466,1469,12706,2318,4377,1418,2959
467,1470,12686,2319,3272,1421,1851
468,1471,12717,2320,530,197,333
469,1472,12714,2320,287,59,228
470,1473,12705,2323,876,110,766
471,1474,12695,2342,40,12,28
472,1476,12686,2322,822,265,557
473,1477,12683,2321,303,65,238
474,1478,12699,2322,673,165,508
475,1479,12699,2335,378,183,195
476,1480,12691,2321,444,73,371
477,1481,12714,2325,70,16,54
478,1482,12714,2324,13,2,11
479,1483,12692,2329,7997,4022,3975
480,1484,12710,2324,74,22,52
481,1485,12685,2321,5026,2260,2766
482,1486,12694,2323,169,48,121
483,1487,12670,2338,91,47,44
484,1488,12679,2311,295,107,188
485,1489,12683,2315,193,71,122
486,1490,12710,2319,1037,334,703
487,1491,12671,2344,82,41,41
488,1492,12685,2319,1599,706,893
489,1493,12687,2316,1018,346,672
490,1494,12683,2327,499,252,247
491,1495,12679,2312,497,111,386
492,1496,12683,2313,286,31,255
493,1497,12684,2323,1269,382,887
494,1498,12697,2322,555,150,405
495,1499,12690,2319,728,173,555
496,1500,12678,2315,362,106,256
497,1501,12693,2324,639,101,538
498,1502,12710,2323,11,1,10
499,1503,12696,2331,1253,638,615
500,1504,12681,2329,484,130,354
501,1505,12682,2325,128,46,82
502,1506,12689,2319,299,62,237
503,1507,12689,2331,1636,739,897
504,1508,12706,2322,708,397,311
505,1509,12716,2337,9250,4981,4269
506,1510,12718,2337,5711,3087,2624
507,1511,12715,2337,4979,2299,2680
508,1512,12714,2333,253,77,176
509,1513,12709,2336,211,100,111
510,1514,12711,2337,306,143,163
511,1515,12715,2335,2650,1375,1275
512,1516,12720,2337,11346,6111,5235
513,1517,12717,2337,7429,4059,3370
514,1518,12714,2337,2633,1092,1541
515,1519,12719,2338,3400,1877,1523
516,1520,12716,2338,445,83,362
517,1521,12713,2335,1006,314,692
518,1522,12715,2334,5093,2682,2411
519,1523,12719,2337,8263,4767,3496
520,1524,12717,2339,1592,596,996
521,1525,12719,2339,1600,802,798
522,1526,12718,2338,7369,3829,3540
523,1527,12717,2338,2379,1129,1250
524,1528,12719,2336,3746,1913,1833
525,1529,12721,2339,810,331,479
526,1530,12720,2338,2046,866,1180
527,1531,12730,2332,9,4,5
528,1532,12713,2325,11,1,10
529,1533,12712,2325,2,1,1
530,1534,12710,2326,6,0,6
531,1535,12709,2326,10,1,9
532,1536,12672,2336,137,39,98
533,1537,12682,2341,9,4,5
534,1538,12682,2339,93,50,43
535,1539,12681,2336,8,3,5
536,1540,12692,2327,996,303,693
537,1542,12696,2329,3369,1444,1925
538,1543,12690,2316,176,103,73
539,1546,12680,2332,129,59,70
540,1547,12675,2328,81,2,79
541,1548,12683,2332,641,270,371
542,1549,12684,2333,289,141,148
543,1550,12684,2332,192,96,96
544,1551,12695,2334,1604,753,851
545,1552,12690,2330,3031,1497,1534
546,1553,12681,2327,77,33,44
547,1554,12718,2330,14,7,7
548,1555,12719,2333,55,16,39
549,1556,12706,2323,129,32,97
550,1557,12694,2331,2706,1392,1314
551,1558,12700,2322,820,102,718
552,1559,12694,2335,1553,810,743
553,1560,12682,2327,204,62,142
554,1561,12689,2332,1609,680,929
555,1562,12704,2317,60,36,24
556,1563,12700,2325,235,12,223
557,1564,12682,2321,765,220,545
558,1565,12676,2314,201,19,182
559,1566,12675,2326,436,95,341
560,1567,12683,2322,985,284,701
561,1568,12685,2333,492,245,247
562,1569,12686,2323,905,226,679
563,1570,12681,2333,318,128,190
564,1571,12680,2329,421,177,244
565,1572,12692,2320,1266,444,822
566,1573,12677,2335,16,6,10
567,1574,12683,2325,42,20,22
568,1575,12684,2315,832,204,628
569,1576,12706,2324,550,41,509
570,1577,12723,2323,597,329,268
571,1578,12726,2324,536,180,356
572,1579,12693,2325,637,205,432
573,1580,12691,2322,12,7,5
574,1581,12678,2312,143,44,99
575,1582,12721,2323,73,23,50
576,1583,12720,2323,858,316,542
577,1584,12723,2344,2,1,1
578,1585,12671,2340,53,14,39
579,1586,12721,2327,81,26,55
580,1587,12718,2323,462,63,399
581,1588,12676,2311,46,4,42
582,1589,12673,2327,1249,586,663
583,1590,12697,2330,2091,831,1260
584,1591,12666,2344,31,12,19
585,1592,12675,2315,42,1,41
586,1593,12687,2326,330,49,281
587,1594,12668,2338,487,200,287
588,1595,12670,2337,677,320,357
589,1596,12672,2337,1249,665,584
590,1597,12676,2315,49,1,48
591,1598,12686,2324,267,64,203
592,1599,12688,2332,842,284,558
593,1600,12694,2332,1516,861,655
594,1601,12688,2323,835,194,641
595,1602,12676,2312,64,5,59
596,1603,12693,2340,94,34,60
597,1605,12705,2339,78,30,48
598,1606,12704,2339,60,24,36
599,1607,12689,2323,165,28,137
600,1608,12689,2333,478,153,325
601,1609,12705,2336,382,214,168
602,1610,12726,2325,25,17,8
603,1611,12696,2332,351,94,257
604,1612,12691,2338,1214,506,708
605,1613,12695,2335,1132,535,597
606,1614,12707,2336,142,70,72
607,1615,12708,2336,340,153,187
608,1616,12693,2332,2468,1238,1230
609,1617,12693,2334,111,36,75
610,1618,12693,2333,119,43,76
611,1619,12692,2338,604,364,240
612,1620,12692,2337,686,398,288
613,1621,12691,2337,173,59,114
614,1622,12674,2337,107,40,67
615,1623,12676,2336,17,8,9
616,1624,12677,2336,117,59,58
617,1625,12680,2338,74,42,32
618,1626,12691,2339,491,174,317
619,1627,12695,2332,587,257,330
620,1628,12696,2335,233,89,144
621,1629,12695,2336,1937,1015,922
622,1630,12696,2337,741,359,382
623,1631,12691,2332,1395,636,759
624,1632,12693,2339,183,93,90
625,1633,12692,2339,760,308,452
626,1634,12693,2338,151,69,82
627,1635,12696,2339,155,52,103
628,1636,12699,2337,348,161,187
629,1637,12703,2338,48,25,23
630,1638,12695,2330,1710,611,1099
631,1639,12694,2330,4765,2505,2260
632,1640,12686,2332,174,106,68
633,1641,12690,2337,83,20,63
634,1642,12695,2339,55,20,35
635,1643,12700,2337,173,71,102
636,1644,12698,2335,243,118,125
637,1645,12681,2340,23,10,13
638,1646,12682,2340,28,9,19
639,1647,12684,2341,20,7,13
640,1648,12702,2334,499,246,253
641,1649,12698,2337,230,129,101
642,1650,12690,2338,334,120,214
643,1651,12693,2336,312,168,144
644,1652,12692,2336,138,67,71
645,1653,12693,2337,205,110,95
646,1654,12696,2333,194,78,116
647,1655,12693,2335,209,87,122
648,1656,12696,2338,151,76,75
649,1657,12697,2341,37,23,14
650,1658,12668,2345,30,16,14
651,1659,12698,2315,74,11,63
652,1660,12687,2322,62,32,30
653,1661,12727,2333,220,96,124
654,1662,12717,2333,278,84,194
655,1663,12677,2331,265,96,169
656,1664,12669,2326,48,4,44
657,1665,12675,2340,57,24,33
658,1666,12714,2330,426,204,222
659,1667,12685,2334,86,21,65
660,1668,12699,2329,681,228,453
661,1669,12691,2329,2997,1407,1590
662,1670,12706,2332,316,95,221
663,1671,12693,2315,109,35,74
664,1672,12671,2323,194,46,148
665,1673,12671,2326,123,58,65
666,1674,12669,2332,269,111,158
667,1675,12668,2332,211,90,121
668,1676,12679,2323,628,203,425
669,1677,12697,2331,235,27,208
670,1678,12709,2330,22,5,17
671,1679,12672,2329,80,10,70
672,1680,12691,2328,774,248,526
673,1681,12670,2327,81,36,45
674,1682,12676,2325,157,46,111
675,1683,12697,2325,646,124,522
676,1684,12708,2330,34,1,33
677,1685,12691,2323,273,75,198
678,1686,12678,2343,140,48,92
679,1687,12679,2335,98,47,51
680,1688,12718,2321,216,48,168
681,1689,12713,2331,356,123,233
682,1690,12712,2328,304,162,142
683,1691,12715,2320,512,149,363
684,1692,12679,2329,18,5,13
685,1693,12679,2330,99,13,86
686,1694,12668,2334,133,40,93
687,1695,12690,2328,419,64,355
688,1696,12701,2330,152,30,122
689,1697,12705,2329,5,2,3
690,1698,12709,2325,97,13,84
691,1699,12670,2340,72,21,51
692,1700,12669,2346,10,3,7
693,1701,12668,2336,143,61,82
694,1702,12681,2326,183,37,146
695,1703,12666,2334,110,21,89
696,1704,12706,2336,163,108,55
697,1705,12681,2332,263,121,142
698,1706,12690,2332,1683,807,876
699,1707,12678,2332,100,39,61
700,1708,12667,2335,59,8,51
701,1709,12672,2321,14,2,12
702,1710,12672,2332,51,19,32
703,1711,12713,2332,140,57,83
704,1713,12675,2313,62,8,54
705,1714,12736,2326,23,9,14
706,1715,12707,2318,558,130,428
707,1716,12691,2324,193,23,170
708,1717,12695,2327,1765,683,1082
709,1718,12723,2334,113,24,89
710,1719,12696,2341,2,1,1
711,1720,12701,2337,203,108,95
712,1721,12702,2337,37,20,17
713,1724,12692,2340,7,2,5
714,1725,12705,2330,32,8,24
715,1726,12687,2337,30,15,15
716,1727,12688,2338,73,23,50
717,1728,12689,2338,105,41,64
718,1729,12714,2336,1247,568,679
719,1730,12713,2337,510,230,280
720,1731,12698,2336,238,103,135
721,1732,12705,2331,177,55,122
722,1733,12701,2333,72,33,39
723,1734,12706,2333,165,79,86
724,1735,12704,2333,510,290,220
725,1736,12704,2335,257,122,135
726,1737,12705,2335,175,83,92
727,1739,12736,2328,26,13,13
728,1740,12732,2333,63,19,44
729,1741,12731,2333,65,17,48
730,1742,12725,2332,40,17,23
731,1743,12722,2331,48,12,36
732,1744,12712,2331,80,25,55
733,1745,12683,2339,28,17,11
734,1746,12671,2338,164,67,97
735,1747,12670,2333,101,45,56
736,1748,12677,2337,30,15,15
737,1749,12678,2338,43,15,28
738,1750,12679,2338,226,124,102
739,1751,12683,2338,30,7,23
740,1752,12688,2333,415,140,275
741,1753,12693,2341,18,7,11
742,1754,12689,2330,257,129,128
743,1755,12719,2323,438,99,339
744,1756,12671,2331,62,3,59
745,1757,12718,2336,6625,3525,3100
746,1758,12714,2339,59,7,52
747,1759,12690,2331,425,105,320
748,1760,12712,2335,158,27,131
749,1761,12676,2330,221,17,204
750,1762,12694,2338,264,65,199
751,1763,12717,2323,150,5,145
752,1764,12704,2331,99,27,72
753,1765,12698,2338,104,14,90
754,1766,12692,2324,48,1,47
755,1767,12723,2325,132,19,113
756,1768,12719,2322,142,47,95
757,1769,12704,2330,112,44,68
758,1770,12698,2334,65,26,39
759,1771,12705,2328,56,5,51
760,1772,12702,2328,98,9,89
761,1773,12712,2337,427,205,222
762,1774,12669,2328,141,133,8
763,1775,12714,2334,663,226,437
764,1776,12711,2327,61,12,49
765,1777,12715,2330,100,41,59
766,1778,12700,2329,150,7,143
767,1779,12687,2324,53,8,45
768,1780,12699,2330,27,2,25
769,1781,12720,2336,715,306,409
770,1782,12728,2333,339,140,199
771,1783,12727,2334,519,294,225
772,1784,12721,2338,3475,1750,1725
773,1785,12719,2335,841,418,423
774,1786,12723,2342,106,28,78
775,1787,12720,2339,1469,651,818
776,1788,12744,2317,13,7,6
777,1789,12738,2325,10,3,7
778,1790,12725,2336,73,16,57
779,1791,12725,2334,93,28,65
780,1792,12725,2335,244,116,128
781,1793,12722,2338,239,64,175
782,1794,12724,2336,688,290,398
783,1795,12725,2338,95,27,68
784,1796,12724,2340,11,3,8
785,1797,12723,2341,401,212,189
786,1798,12721,2329,1,1,0
787,1799,12714,2335,921,369,552
788,1800,12731,2339,103,37,66
789,1801,12732,2339,22,7,15
790,1802,12723,2338,136,30,106
791,1803,12723,2337,312,134,178
792,1804,12729,2336,20,12,8
793,1805,12726,2334,221,123,98
794,1806,12726,2338,44,13,31
795,1807,12737,2340,1,1,0
796,1808,12729,2332,57,15,42
797,1809,12722,2340,198,80,118
798,1810,12720,2332,79,15,64
799,1811,12717,2329,44,8,36
800,1812,12716,2332,123,35,88
801,1813,12721,2335,100,31,69
802,1814,12725,2333,32,16,16
803,1815,12726,2341,53,17,36
804,1816,12709,2329,306,17,289
805,1817,12707,2323,221,110,111
806,1818,12738,2327,11,3,8
807,1819,12720,2322,86,3,83
808,1820,12715,2328,118,43,75
809,1821,12668,2339,31,11,20
810,1822,12666,2333,138,32,106
811,1823,12676,2345,10,5,5
812,1824,12672,2345,32,13,19
813,1825,12674,2335,1,0,1
814,1826,12700,2326,162,15,147
815,1827,12679,2343,36,12,24
816,1828,12712,2319,36,14,22
817,1829,12730,2335,25,5,20
818,1830,12724,2335,350,138,212
819,1831,12713,2328,219,95,124
820,1832,12709,2327,48,21,27
821,1833,12710,2329,371,91,280
822,1834,12692,2332,325,107,218
823,1835,12673,2341,417,185,232
824,1836,12672,2340,121,65,56
825,1837,12671,2339,48,29,19
826,1838,12672,2339,524,236,288
827,1839,12694,2322,9,2,7
828,1840,12682,2323,372,92,280
829,1841,12716,2329,122,48,74
830,1842,12716,2333,550,231,319
831,1843,12714,2332,419,219,200
832,1844,12714,2328,143,53,90
833,1847,12715,2331,28,11,17
834,1848,12708,2334,147,65,82
835,1849,12715,2329,116,53,63
836,1850,12714,2326,79,25,54
837,1851,12714,2331,554,283,271
838,1852,12717,2331,54,24,30
839,1853,12721,2341,174,52,122
840,1854,12721,2340,293,140,153
841,1855,12723,2332,20,13,7
842,1856,12716,2330,105,45,60
843,1857,12720,2334,968,426,542
844,1858,12716,2323,31,1,30
845,1860,12728,2334,180,77,103
846,1861,12727,2335,19,3,16
847,1862,12714,2329,66,37,29
848,1863,12711,2330,192,52,140
849,1864,12720,2335,287,113,174
850,1865,12717,2334,183,66,117
851,1866,12712,2327,11,1,10
852,1867,12720,2331,7,4,3
853,1869,12678,2311,98,6,92
854,1870,12685,2327,4,0,4
855,1871,12675,2314,201,18,183
856,1872,12664,2344,12,1,11
857,1873,12674,2331,112,9,103
858,1874,12688,2322,114,52,62
859,1875,12689,2320,186,62,124
860,1876,12680,2336,60,14,46
861,1877,12724,2325,36,1,35
862,1878,12749,2312,2,0,2
863,1879,12707,2324,145,48,97
864,1880,12678,2336,122,44,78
865,1881,12726,2332,61,30,31
866,1882,12703,2316,35,22,13
867,1883,12683,2333,166,38,128
868,1884,12707,2338,57,22,35
869,1885,12708,2339,23,10,13
870,1886,12674,2341,66,38,28
871,1887,12675,2343,53,22,31
872,1889,12690,2334,7,1,6
873,1890,12667,2338,181,67,114
874,1891,12716,2339,459,150,309
875,1892,12720,2333,367,125,242
876,1893,12715,2339,681,207,474
877,1894,12717,2340,327,69,258
878,1895,12718,2335,839,264,575
879,1896,12713,2336,530,115,415
880,1897,12721,2336,315,105,210
881,1898,12712,2332,44,4,40
882,1899,12718,2339,354,106,248
883,1900,12705,2332,218,82,136
884,1901,12713,2340,2,0,2
885,1902,12722,2336,636,229,407
886,1903,12723,2333,58,11,47
887,1904,12713,2338,71,10,61
888,1905,12714,2340,52,6,46
889,1906,12724,2342,357,142,215
890,1907,12729,2337,32,10,22
891,1908,12697,2335,87,41,46
892,1909,12680,2334,61,33,28
893,1910,12715,2326,42,10,32
894,1911,12707,2333,85,46,39
895,1912,12724,2323,110,66,44
896,1914,12702,2330,83,24,59
897,1915,12680,2337,12,4,8
898,1916,12722,2324,42,2,40
899,1917,12720,2341,64,12,52
900,1918,12718,2334,67,18,49
901,1919,12721,2334,169,31,138
902,1920,12720,2340,128,18,110
903,1921,12713,2334,55,8,47
904,1922,12721,2333,206,49,157
905,1923,12707,2337,5,2,3
906,1924,12715,2338,322,91,231
907,1925,12715,2340,35,2,33
908,1926,12717,2321,146,80,66
909,1927,12679,2341,158,83,75
910,1928,12679,2340,188,101,87
911,1929,12683,2340,36,12,24
912,1930,12692,2333,36,16,20
913,1931,12682,2334,57,7,50
914,1932,12675,2331,110,50,60
915,1936,12734,2333,7,2,5
916,1937,12744,2321,5,1,4
917,1938,12677,2342,272,96,176
918,1939,12679,2337,175,82,93
919,1940,12689,2334,275,52,223
920,1941,12686,2334,122,23,99
921,1942,12698,2323,43,2,41
922,1943,12677,2315,98,5,93
923,1944,12683,2324,95,47,48
924,1945,12693,2323,57,29,28
925,1946,12683,2312,64,16,48
926,1947,12676,2310,19,0,19
927,1948,12673,2329,25,3,22
928,1949,12671,2337,369,171,198
929,1950,12672,2341,462,175,287
930,1951,12690,2320,105,6,99
931,1952,12725,2324,59,23,36
932,1953,12673,2336,92,25,67
933,1954,12672,2335,47,7,40
934,1955,12679,2342,79,26,53
935,1956,12702,2329,74,7,67
936,1957,12692,2321,2,1,1
937,1958,12673,2337,145,56,89
938,1959,12687,2331,3,0,3
939,1960,12678,2331,79,30,49
940,1961,12735,2329,19,13,6
941,1962,12736,2327,69,17,52
942,1963,12729,2333,95,37,58
943,1964,12726,2343,52,15,37
944,1965,12725,2343,48,22,26
945,1966,12722,2342,45,13,32
946,1967,12724,2334,52,13,39
947,1968,12736,2329,10,6,4
948,1969,12710,2336,267,102,165
949,1970,12691,2326,73,19,54
950,1971,12691,2325,50,18,32
951,1972,12680,2340,25,9,16
952,1973,12677,2314,142,30,112
953,1974,12690,2323,37,14,23
954,1975,12677,2343,166,61,105
955,1976,12710,2322,57,8,49
956,1979,12725,2341,89,24,65
957,1980,12723,2331,36,11,25
958,1982,12737,2342,9,2,7
959,1983,12716,2331,43,20,23
960,1984,12724,2333,41,13,28
961,1985,12724,2331,15,5,10
962,1986,12723,2335,33,4,29
963,1987,12682,2331,79,20,59
964,1988,12670,2346,24,9,15
965,1989,12682,2330,28,8,20
966,1990,12696,2334,29,3,26
967,1991,12674,2318,25,3,22
968,1992,12667,2339,65,18,47
969,1993,12669,2337,73,44,29
970,1994,12673,2335,43,9,34
971,1995,12707,2329,95,14,81
972,1996,12690,2327,27,3,24
973,1997,12704,2329,90,28,62
974,1998,12708,2329,27,9,18
975,1999,12692,2323,77,40,37
976,2000,12670,2335,106,41,65
977,2001,12670,2336,126,47,79
978,2002,12697,2324,32,15,17
979,2003,12668,2341,24,3,21
980,2006,12683,2341,101,40,61
981,2007,12681,2338,101,29,72
982,2008,12669,2340,59,19,40
983,2009,12668,2346,19,10,9
984,2010,12671,2343,48,23,25
985,2011,12675,2341,45,21,24
986,2012,12673,2339,112,60,52
987,2013,12677,2338,57,17,40
988,2014,12669,2342,28,6,22
989,2015,12672,2342,246,88,158
990,2016,12684,2338,60,27,33
991,2019,12676,2343,102,42,60
992,2020,12673,2340,162,93,69
993,2021,12677,2344,25,7,18
994,2022,12678,2342,317,174,143
995,2023,12677,2339,29,12,17
996,2024,12677,2334,17,10,7
997,2025,12682,2329,2,1,1
998,2027,12701,2331,4,0,4
999,2028,12679,2331,70,28,42
1000,2029,12665,2332,68,19,49
1001,2030,12686,2325,108,35,73
1002,2031,12703,2328,37,6,31
1003,2032,12674,2343,13,4,9
1004,2033,12678,2340,14,3,11
1005,2034,12666,2335,62,8,54
1006,2035,12665,2334,22,2,20
1007,2036,12669,2333,47,11,36
1008,2037,12670,2342,26,6,20
1009,2038,12667,2346,19,5,14
1010,2040,12689,2329,9,7,2
1011,2041,12691,2333,50,13,37
1012,2042,12701,2336,132,53,79
1013,2043,12722,2330,19,9,10
1014,2044,12724,2338,43,15,28
1015,2045,12724,2337,102,26,76
1016,2046,12716,2340,128,20,108
1017,2047,12724,2341,88,22,66
1018,2048,12706,2339,49,17,32
1019,2049,12708,2337,29,12,17
1020,2050,12709,2337,31,15,16
1021,2051,12710,2337,61,25,36
1022,2052,12706,2338,8,3,5
1023,2053,12718,2333,84,23,61
1024,2054,12722,2333,74,8,66
1025,2055,12714,2338,134,29,105
1026,2056,12722,2339,26,5,21
1027,2057,12666,2332,116,27,89
1028,2058,12710,2330,80,9,71
1029,2059,12680,2342,28,17,11
1030,2061,12680,2335,73,45,28
1031,2062,12677,2345,26,9,17
1032,2063,12735,2330,4,2,2
1033,2064,12733,2332,13,5,8
1034,2065,12710,2338,7,3,4
1035,2066,12708,2323,9,3,6
1036,2067,12702,2316,35,26,9
1037,2068,12673,2342,137,63,74
1038,2069,12688,2334,101,13,88
1039,2070,12676,2313,20,6,14
1040,2073,12709,2323,11,0,11
1041,2074,12665,2338,26,7,19
1042,2075,12676,2326,221,54,167
1043,2076,12677,2346,9,2,7
1044,2077,12665,2333,47,7,40
1045,2078,12720,2327,63,9,54
1046,2079,12692,2334,5,1,4
1047,2080,12677,2332,22,10,12
1048,2081,12682,2338,17,3,14
1049,2082,12704,2338,32,16,16
1050,2083,12685,2332,58,26,32
1051,2084,12700,2335,73,27,46
1052,2085,12706,2334,25,13,12
1053,2086,12699,2338,34,14,20
1054,2087,12667,2331,122,40,82
1055,2088,12666,2338,45,11,34
1056,2089,12711,2319,138,51,87
1057,2090,12706,2328,40,20,20
1058,2092,12682,2326,29,2,27
1059,2093,12687,2333,107,30,77
1060,2094,12681,2311,1,0,1
1061,2095,12684,2328,104,10,94
1062,2096,12681,2334,61,17,44
1063,2097,12733,2340,18,12,6
1064,2098,12695,2337,90,24,66
1065,2099,12667,2327,3,3,0
1066,2100,12717,2324,67,4,63
1067,2101,12722,2341,38,10,28
1068,2102,12734,2326,6,0,6
1069,2103,12731,2336,2,1,1
1070,2104,12728,2340,9,7,2
1071,2105,12732,2340,16,7,9
1072,2106,12723,2340,56,18,38
1073,2107,12723,2343,35,5,30
1074,2108,12728,2332,42,11,31
1075,2109,12726,2340,11,4,7
1076,2110,12688,2324,30,0,30
1077,2111,12717,2322,28,4,24
1078,2112,12720,2330,11,5,6
1079,2113,12721,2330,5,2,3
1080,2117,12697,2340,12,6,6
1081,2118,12694,2340,28,9,19
1082,2119,12673,2344,29,16,13
1083,2120,12668,2347,3,2,1
1084,2121,12730,2325,15,1,14
1085,2123,12670,2341,41,14,27
1086,2124,12720,2328,1,0,1
1087,2125,12731,2325,10,3,7
1088,2126,12730,2333,64,32,32
1089,2127,12699,2336,38,10,28
1090,2128,12716,2321,24,9,15
1091,2129,12679,2314,17,9,8
1092,2130,12731,2338,23,3,20
1093,2131,12712,2334,13,7,6
1094,2132,12712,2333,65,8,57
1095,2133,12727,2344,11,4,7
1096,2134,12726,2344,38,14,24
1097,2135,12721,2342,43,8,35
1098,2136,12731,2326,1,1,0
1099,2137,12737,2326,16,5,11
1100,2138,12740,2324,6,5,1
1101,2139,12742,2324,12,3,9
1102,2140,12742,2323,25,6,19
1103,2141,12678,2317,7,1,6
1104,2143,12700,2338,51,17,34
1105,2144,12697,2338,28,17,11
1106,2145,12677,2318,15,2,13
1107,2146,12679,2339,66,38,28
1108,2147,12674,2340,27,10,17
1109,2148,12669,2336,132,60,72
1110,2149,12668,2337,114,34,80
1111,2150,12671,2341,103,39,64
1112,2151,12673,2333,64,18,46
1113,2152,12730,2340,23,11,12
1114,2153,12716,2325,4,1,3
1115,2154,12726,2333,95,47,48
1116,2155,12719,2330,11,7,4
1117,2156,12717,2330,53,12,41
1118,2157,12715,2327,38,10,28
1119,2158,12699,2325,1,1,0
1120,2159,12692,2325,16,2,14
1121,2160,12673,2343,29,13,16
1122,2161,12721,2331,28,10,18
1123,2162,12678,2339,8,4,4
1124,2163,12679,2345,10,3,7
1125,2164,12681,2342,24,10,14
1126,2165,12687,2338,17,4,13
1127,2170,12674,2339,17,13,4
1128,2171,12684,2343,7,5,2
1129,2172,12669,2345,28,13,15
1130,2173,12682,2343,23,12,11
1131,2174,12675,2339,7,5,2
1132,2175,12684,2344,33,9,24
1133,2176,12678,2341,45,25,20
1134,2177,12738,2326,1,1,0
1135,2178,12686,2338,42,25,17
1136,2179,12675,2342,46,23,23
1137,2181,12685,2340,12,1,11
1138,2183,12678,2344,45,21,24
1139,2184,12665,2342,10,5,5
1140,2185,12674,2342,17,9,8
1141,2186,12667,2336,53,20,33
1142,2187,12677,2311,26,0,26
1143,2189,12725,2337,131,38,93
1144,2190,12726,2335,17,10,7
1145,2191,12734,2334,13,2,11
1146,2192,12734,2336,7,3,4
1147,2193,12712,2336,21,0,21
1148,2194,12735,2325,6,1,5
1149,2195,12734,2340,25,9,16
1150,2197,12667,2329,2,2,0
1151,2198,12732,2325,2,0,2
1152,2199,12667,2337,48,19,29
1153,2201,12692,2335,6,2,4
1154,2202,12691,2336,7,0,7
1155,2203,12701,2338,28,13,15
1156,2206,12730,2334,20,3,17
1157,2207,12671,2321,2,1,1
1158,2208,12721,2343,4,0,4
1159,2209,12676,2344,31,7,24
1160,2210,12666,2342,4,2,2
1161,2211,12667,2344,20,11,9
1162,2212,12733,2335,9,4,5
1163,2213,12731,2340,23,13,10
1164,2214,12743,2323,7,0,7
1165,2215,12746,2323,8,0,8
1166,2217,12722,2334,59,14,45
1167,2219,12716,2341,18,1,17
1168,2220,12729,2335,40,18,22
1169,2222,12676,2346,21,7,14
1170,2223,12666,2330,1,1,0
1171,2224,12666,2336,23,7,16
1172,2225,12712,2320,29,9,20
1173,2231,12724,2332,30,13,17
1174,2232,12666,2343,13,4,9
1175,2233,12696,2314,10,5,5
1176,2234,12750,2312,2,0,2
1177,2235,12722,2335,17,3,14
1178,2236,12665,2344,12,1,11
1179,2240,12684,2340,33,7,26
1180,2241,12675,2319,40,7,33
1181,2242,12668,2344,13,6,7
1182,2243,12669,2339,54,27,27
1183,2244,12729,2334,14,4,10
1184,2245,12737,2328,12,3,9
1185,2247,12689,2322,27,11,16
1186,2248,12676,2317,1,0,1
1187,2249,12708,2322,3,0,3
1188,2250,12667,2334,59,19,40
1189,2251,12710,2321,28,4,24
1190,2252,12679,2313,12,2,10
1191,2253,12708,2328,21,7,14
1192,2254,12699,2326,42,12,30
1193,2255,12718,2322,42,11,31
1194,2256,12678,2318,35,1,34
1195,2257,12680,2327,6,1,5
1196,2258,12698,2332,28,7,21
1197,2259,12683,2331,43,14,29
1198,2260,12675,2337,33,21,12
1199,2261,12676,2337,11,6,5
1200,2262,12667,2341,15,3,12
1201,2263,12676,2342,18,8,10
1202,2265,12668,2342,13,5,8
1203,2266,12691,2340,3,0,3
1204,2267,12674,2344,30,11,19
1205,2268,12690,2324,18,2,16
1206,2269,12700,2339,14,4,10
1207,2270,12664,2338,8,0,8
1208,2274,12696,2342,5,2,3
1209,2275,12704,2337,35,15,20
1210,2276,12665,2335,18,4,14
1211,2277,12732,2337,12,2,10
1212,2278,12729,2340,27,15,12
1213,2279,12735,2340,12,3,9
1214,2280,12727,2332,30,13,17
1215,2281,12681,2339,21,12,9
1216,2282,12666,2339,29,4,25
1217,2283,12686,2335,19,0,19
1218,2284,12689,2321,34,11,23
1219,2285,12687,2321,21,2,19
1220,2286,12730,2337,6,3,3
1221,2287,12722,2323,34,7,27
1222,2288,12675,2327,61,1,60
1223,2289,12684,2327,10,0,10
1224,2291,12719,2334,28,4,24
1225,2292,12722,2343,11,1,10
1226,2293,12700,2331,12,3,9
1227,2294,12688,2330,12,6,6
1228,2295,12711,2336,14,2,12
1229,2296,12694,2341,32,9,23
1230,2299,12749,2311,2,0,2
1231,2300,12747,2323,1,0,1
1232,2301,12701,2335,22,10,12
1233,2302,12685,2335,20,5,15
1234,2303,12703,2335,74,26,48
1235,2304,12708,2335,91,47,44
1236,2305,12673,2330,5,0,5
1237,2306,12676,2340,27,19,8
1238,2307,12679,2344,15,7,8
1239,2308,12672,2347,2,1,1
1240,2309,12675,2344,29,7,22
1241,2310,12678,2345,15,6,9
1242,2311,12671,2345,38,13,25
1243,2312,12678,2337,26,5,21
1244,2313,12677,2333,28,8,20
1245,2314,12685,2338,33,19,14
1246,2316,12683,2344,20,10,10
1247,2317,12682,2342,3,1,2
1248,2318,12682,2336,10,2,8
1249,2319,12672,2331,2,1,1
1250,2320,12687,2334,13,4,9
1251,2321,12733,2336,16,3,13
1252,2322,12685,2344,7,1,6
1253,2323,12717,2341,24,2,22
1254,2328,12725,2342,44,12,32
1255,2329,12731,2335,19,5,14
1256,2330,12704,2336,19,6,13
1257,2331,12737,2327,13,3,10
1258,2333,12709,2335,6,2,4
1259,2334,12705,2334,290,112,178
1260,2335,12741,2327,2,0,2
1261,2336,12743,2328,1,1,0
1262,2341,12666,2346,14,3,11
1263,2342,12748,2323,10,1,9
1264,2343,12718,2341,6,2,4
1265,2346,12698,2339,6,1,5
1266,2347,12698,2340,5,3,2
1267,2348,12726,2345,28,12,16
1268,2349,12724,2346,3,2,1
1269,2350,12668,2326,17,0,17
1270,2353,12707,2322,5,3,2
1271,2355,12681,2341,14,3,11
1272,2356,12666,2347,2,0,2
1273,2358,12688,2326,11,1,10
1274,2359,12734,2343,1,0,1
1275,2360,12731,2341,16,6,10
1276,2361,12717,2325,6,0,6
1277,2362,12743,2318,7,0,7
1278,2365,12674,2346,10,1,9
1279,2366,12726,2346,21,12,9
1280,2369,12683,2337,14,7,7
1281,2371,12735,2341,16,5,11
1282,2372,12693,2322,3,3,0
1283,2374,12723,2322,28,15,13
1284,2376,12694,2339,41,14,27
1285,2378,12678,2346,3,1,2
1286,2379,12686,2327,37,0,37
1287,2380,12676,2347,9,3,6
1288,2381,12683,2336,2,0,2
1289,2382,12735,2344,1,1,0
1290,2383,12733,2343,2,0,2
1291,2384,12733,2342,1,1,0
1292,2385,12732,2342,4,0,4
1293,2386,12729,2338,27,14,13
1294,2387,12728,2335,45,13,32
1295,2388,12700,2323,2,0,2
1296,2389,12666,2340,5,1,4
1297,2391,12719,2340,9,5,4
1298,2392,12666,2337,15,3,12
1299,2393,12684,2337,17,9,8
1300,2394,12709,2322,15,5,10
1301,2395,12683,2334,12,1,11
1302,2398,12709,2334,30,12,18
1303,2399,12705,2338,7,3,4
1304,2400,12702,2332,5,1,4
1305,2401,12708,2338,9,3,6
1306,2404,12694,2342,12,4,8
1307,2405,12693,2342,16,10,6
1308,2407,12674,2345,14,4,10
1309,2408,12675,2345,20,9,11
1310,2409,12699,2331,9,3,6
1311,2410,12727,2341,20,10,10
1312,2411,12718,2340,26,2,24
1313,2412,12726,2336,3,0,3
1314,2413,12726,2337,17,6,11
1315,2414,12739,2324,6,4,2
1316,2415,12733,2339,3,1,2
1317,2416,12724,2330,1,0,1
1318,2417,12688,2321,9,5,4
1319,2418,12709,2339,4,2,2
1320,2423,12702,2338,10,4,6
1321,2424,12707,2335,14,5,9
1322,2425,12730,2339,43,23,20
1323,2426,12728,2341,12,6,6
1324,2427,12726,2342,4,1,3
1325,2428,12685,2345,6,3,3
1326,2429,12667,2330,2,1,1
1327,2432,12665,2346,1,1,0
1328,2435,12736,2341,41,26,15
1329,2436,12729,2325,16,1,15
1330,2437,12708,2331,2,1,1
1331,2438,12716,2328,12,1,11
1332,2439,12726,2331,14,1,13
1333,2441,12688,2337,19,6,13
1334,2442,12709,2333,9,3,6
1335,2443,12684,2334,4,0,4
1336,2444,12711,2325,2,2,0
1337,2446,12725,2344,2,0,2
1338,2449,12722,2332,7,4,3
1339,2450,12743,2324,3,1,2
1340,2451,12668,2325,1,1,0
1341,2453,12697,2342,31,12,19
1342,2456,12673,2346,2,0,2
1343,2457,12721,2326,4,1,3
1344,2458,12722,2322,9,4,5
1345,2460,12674,2336,31,5,26
1346,2461,12711,2331,8,2,6
1347,2462,12678,2316,18,3,15
1348,2463,12709,2332,18,10,8
1349,2464,12680,2344,1,0,1
1350,2465,12731,2334,6,1,5
1351,2466,12748,2319,1,0,1
1352,2467,12737,2341,15,8,7
1353,2468,12709,2331,15,10,5
1354,2470,12734,2337,1,0,1
1355,2472,12732,2332,9,1,8
1356,2473,12732,2336,8,3,5
1357,2474,12734,2339,4,2,2
1358,2475,12734,2335,6,2,4
1359,2476,12730,2338,13,5,8
1360,2477,12690,2340,6,3,3
1361,2478,12664,2337,9,1,8
1362,2479,12732,2341,3,2,1
1363,2480,12741,2324,8,6,2
1364,2481,12707,2334,7,6,1
1365,2485,12735,2334,6,2,4
1366,2486,12733,2334,8,6,2
1367,2488,12664,2345,1,0,1
1368,2490,12718,2331,2,0,2
1369,2491,12722,2329,1,1,0
1370,2492,12674,2319,10,2,8
1371,2493,12728,2324,22,6,16
1372,2494,12713,2320,8,5,3
1373,2495,12708,2326,11,2,9
1374,2496,12676,2316,6,1,5
1375,2497,12699,2333,24,6,18
1376,2498,12665,2337,26,6,20
1377,2502,12703,2339,22,12,10
1378,2504,12680,2310,3,1,2
1379,2507,12668,2327,3,0,3
1380,2510,12684,2325,8,7,1
1381,2511,12675,2317,2,2,0
1382,2512,12681,2337,5,0,5
1383,2514,12672,2344,10,2,8
1384,2517,12718,2324,1,0,1
1385,2518,12721,2328,12,2,10
1386,2522,12707,2331,13,3,10
1387,2523,12700,2316,5,3,2
1388,2524,12716,2324,18,1,17
1389,2526,12665,2345,6,3,3
1390,2528,12670,2344,3,0,3
1391,2529,12669,2344,8,5,3
1392,2530,12691,2316,6,3,3
1393,2531,12695,2340,8,1,7
1394,2533,12696,2340,18,11,7
1395,2534,12679,2310,10,1,9
1396,2535,12743,2322,3,1,2
1397,2536,12739,2327,1,1,0
1398,2537,12734,2330,9,6,3
1399,2538,12677,2347,3,2,1
1400,2539,12724,2343,7,0,7
1401,2540,12670,2322,1,1,0
1402,2543,12689,2325,1,0,1
1403,2544,12737,2325,4,2,2
1404,2545,12734,2331,1,0,1
1405,2546,12733,2331,8,3,5
1406,2547,12715,2321,6,4,2
1407,2552,12678,2325,2,0,2
1408,2553,12689,2328,3,0,3
1409,2554,12715,2318,3,1,2
1410,2555,12668,2328,1,1,0
1411,2557,12676,2318,2,1,1
1412,2558,12676,2339,8,5,3
1413,2559,12677,2326,3,1,2
1414,2560,12680,2328,15,2,13
1415,2561,12672,2346,14,2,12
1416,2565,12687,2325,34,0,34
1417,2571,12689,2339,2,1,1
1418,2572,12730,2336,2,0,2
1419,2573,12679,2324,23,1,22
1420,2574,12734,2341,5,2,3
1421,2575,12684,2313,6,0,6
1422,2579,12673,2345,12,3,9
1423,2580,12705,2317,14,8,6
1424,2581,12697,2339,7,2,5
1425,2583,12743,2319,18,4,14
1426,2584,12727,2343,4,1,3
1427,2585,12725,2346,2,0,2
1428,2586,12675,2335,7,0,7
1429,2587,12662,2344,4,0,4
1430,2589,12684,2342,5,2,3
1431,2590,12745,2323,1,0,1
1432,2592,12717,2332,3,0,3
1433,2593,12710,2335,14,10,4
1434,2594,12736,2325,1,1,0
1435,2595,12742,2321,1,0,1
1436,2597,12732,2335,5,2,3
1437,2598,12732,2334,7,2,5
1438,2599,12731,2332,5,0,5
1439,2605,12713,2322,1,0,1
1440,2606,12700,2333,16,6,10
1441,2607,12675,2347,5,1,4
1442,2609,12666,2327,1,1,0
1443,2610,12711,2338,3,1,2
1444,2611,12723,2339,3,2,1
1445,2613,12698,2331,6,0,6
1446,2614,12727,2338,1,0,1
1447,2615,12733,2338,3,0,3
1448,2616,12682,2311,3,2,1
1449,2620,12727,2324,4,1,3
1450,2621,12722,2327,8,2,6
1451,2622,12687,2327,6,0,6
1452,2623,12701,2332,1,0,1
1453,2624,12688,2327,3,1,2
1454,2629,12711,2326,1,0,1
1455,2638,12751,2318,1,1,0
1456,2639,12675,2349,10,1,9
1457,2640,12699,2339,9,4,5
1458,2641,12686,2341,3,0,3
1459,2642,12733,2325,3,0,3
1460,2643,12669,2327,4,2,2
1461,2644,12665,2343,4,2,2
1462,2645,12676,2309,1,0,1
1463,2646,12668,2329,6,5,1
1464,2647,12710,2332,1,0,1
1465,2649,12677,2310,4,0,4
1466,2650,12741,2321,5,0,5
1467,2651,12695,2314,4,2,2
1468,2652,12712,2323,7,0,7
1469,2656,12705,2337,2,1,1
1470,2658,12682,2344,2,1,1
1471,2660,12674,2338,8,0,8
1472,2661,12668,2343,8,6,2
1473,2662,12665,2331,6,2,4
1474,2663,12716,2322,3,0,3
1475,2664,12675,2308,1,0,1
1476,2666,12675,2318,1,0,1
1477,2667,12686,2331,1,1,0
1478,2669,12686,2328,3,0,3
1479,2671,12670,2343,9,3,6
1480,2672,12688,2335,6,1,5
1481,2674,12672,2330,4,4,0
1482,2675,12683,2345,5,1,4
1483,2678,12709,2338,5,1,4
1484,2679,12699,2316,12,8,4
1485,2680,12745,2319,1,1,0
1486,2681,12736,2334,7,2,5
1487,2683,12731,2337,1,1,0
1488,2684,12680,2339,1,0,1
1489,2686,12699,2324,3,1,2
1490,2688,12722,2325,6,2,4
1491,2689,12682,2335,1,0,1
1492,2692,12713,2323,1,0,1
1493,2695,12716,2326,2,0,2
1494,2697,12711,2332,2,1,1
1495,2702,12685,2314,3,3,0
1496,2706,12676,2341,2,0,2
1497,2707,12738,2341,2,2,0
1498,2708,12668,2348,2,1,1
1499,2710,12753,2318,1,0,1
1500,2711,12753,2319,2,1,1
1501,2712,12744,2318,4,2,2
1502,2714,12734,2325,5,1,4
1503,2715,12675,2316,2,0,2
1504,2718,12728,2342,3,2,1
1505,2720,12733,2341,1,1,0
1506,2721,12730,2330,2,0,2
1507,2724,12737,2335,1,1,0
1508,2725,12746,2324,2,0,2
1509,2726,12667,2340,31,7,24
1510,2727,12744,2320,2,2,0
1511,2728,12725,2331,5,2,3
1512,2730,12732,2338,2,0,2
1513,2731,12740,2321,2,1,1
1514,2732,12735,2328,3,1,2
1515,2733,12669,2347,2,1,1
1516,2735,12721,2324,2,0,2
1517,2737,12721,2344,2,2,0
1518,2738,12679,2325,1,0,1
1519,2741,12669,2343,3,1,2
1520,2744,12683,2328,3,1,2
1521,2746,12713,2327,7,2,5
1522,2748,12679,2328,5,4,1
1523,2749,12677,2316,3,0,3
1524,2751,12735,2342,1,0,1
1525,2752,12729,2341,2,0,2
1526,2753,12729,2326,1,0,1
1527,2754,12727,2342,1,1,0
1528,2756,12744,2322,1,0,1
1529,2758,12679,2332,3,0,3
1530,2759,12700,2324,1,0,1
1531,2760,12688,2339,2,0,2
1532,2768,12680,2333,3,0,3
1533,2770,12688,2325,1,1,0
1534,2773,12735,2326,2,0,2
1535,2774,12664,2333,1,0,1
1536,2776,12684,2339,5,4,1
1537,2781,12690,2321,2,1,1
1538,2782,12690,2325,2,1,1
1539,2785,12689,2324,3,0,3
1540,2790,12684,2324,2,1,1
1541,2791,12729,2331,2,0,2
1542,2793,12676,2348,3,2,1
1543,2794,12663,2345,1,1,0
1544,2795,12727,2337,3,2,1
1545,2796,12728,2337,2,1,1
1546,2798,12673,2332,1,0,1
1547,2806,12745,2320,1,0,1
1548,2807,12675,2348,4,1,3
1549,2808,12699,2323,2,2,0
1550,2811,12686,2340,1,0,1
1551,2812,12711,2324,3,0,3
1552,2813,12720,2329,1,1,0
1553,2815,12683,2329,1,0,1
1554,2817,12699,2340,2,0,2
1555,2820,12674,2310,2,1,1
1556,2821,12667,2342,1,0,1
1557,2823,12668,2330,1,0,1
1558,2824,12695,2322,3,2,1
1559,2829,12673,2334,3,1,2
1560,2830,12683,2342,2,0,2
1561,2831,12685,2325,1,1,0
1562,2832,12685,2315,1,0,1
1563,2833,12734,2338,3,0,3
1564,2835,12736,2342,4,2,2
1565,2836,12680,2341,9,3,6
1566,2840,12720,2342,3,0,3
1567,2841,12734,2344,1,0,1
1568,2845,12736,2343,1,0,1
1569,2846,12703,2336,1,0,1
1570,2847,12697,2334,5,3,2
1571,2850,12751,2320,1,1,0
1572,2854,12689,2335,1,1,0
1573,2858,12680,2326,2,0,2
1574,2865,12685,2336,5,1,4
1575,2868,12719,2321,1,1,0
1576,2869,12679,2327,1,1,0
1577,2870,12750,2317,2,0,2
1578,2871,12683,2343,4,2,2
1579,2872,12684,2312,1,0,1
1580,2873,12685,2341,3,0,3
1581,2874,12719,2332,1,0,1
1582,2875,12717,2319,3,0,3
1583,2876,12675,2346,2,0,2
1584,2877,12721,2332,2,0,2
1585,2881,12686,2329,1,0,1
1586,2883,12678,2334,3,2,1
1587,2885,12727,2345,1,1,0
1588,2886,12741,2323,1,0,1
1589,2887,12674,2349,2,1,1
1590,2888,12666,2341,2,0,2
1591,2897,12707,2339,1,0,1
1592,2901,12734,2342,1,0,1
1593,2902,12745,2324,2,2,0
1594,2905,12727,2331,1,0,1
1595,2909,12666,2331,1,0,1
1596,2910,12711,2321,2,1,1
1597,2913,12711,2322,1,0,1
1598,2916,12741,2320,2,0,2
1599,2918,12736,2344,1,0,1
1600,2919,12751,2312,1,0,1
1601,2920,12730,2331,2,1,1
1602,2921,12706,2337,1,1,0
1603,2929,12690,2336,3,1,2
1604,2930,12712,2324,1,0,1
1605,2931,12715,2323,1,0,1
1606,2933,12710,2325,1,0,1
1607,2934,12750,2319,1,0,1
1608,2936,12676,2328,1,1,0
1609,2942,12738,2323,1,0,1
1610,2944,12665,2340,2,1,1
1611,2945,12748,2311,2,0,2
1612,2948,12674,2333,2,0,2
1613,2950,12684,2331,1,0,1
1614,2954,12725,2340,2,1,1
1615,2955,12671,2322,1,0,1
1616,2957,12680,2324,4,0,4
1617,2959,12730,2341,3,1,2
1618,2961,12690,2326,1,0,1
1619,2963,12728,2325,1,0,1
1620,2967,12677,2340,1,0,1
1621,2970,12740,2323,2,1,1
1622,2976,12684,2336,1,1,0
1623,2979,12690,2339,1,0,1
1624,2981,12686,2339,2,1,1
1625,2991,12752,2319,1,0,1
1626,2993,12674,2315,1,1,0
1627,2999,12703,2337,1,1,0
1628,3005,12745,2321,1,0,1
1629,3006,12676,2332,2,0,2
1630,3007,12713,2324,1,0,1
1631,3013,12730,2328,1,0,1
1632,3015,12683,2309,2,1,1
1633,3020,12742,2318,2,1,1
1634,3024,12711,2333,1,1,0
